utc_timestamp,AT_solar_generation_actual,AT_wind_onshore_generation_actual,electricity,AT_price_day_ahead,temperature
2017-01-01 00:00:00+00:00,0,86,86,26,-4.973
2017-01-01 01:00:00+00:00,0,72,72,24,-5.201
2017-01-01 02:00:00+00:00,0,73,73,20,-5.3
2017-01-01 03:00:00+00:00,0,69,69,20,-5.15
2017-01-01 04:00:00+00:00,0,77,77,19,-4.985
2017-01-01 05:00:00+00:00,0,73,73,15,-4.899
2017-01-01 06:00:00+00:00,8,65,73,14,-4.904
2017-01-01 07:00:00+00:00,17,55,72,18,-4.583
2017-01-01 08:00:00+00:00,56,60,116,20,-3.124
2017-01-01 09:00:00+00:00,114,60,174,21,-1.198
2017-01-01 10:00:00+00:00,162,50,212,23,0.236
2017-01-01 11:00:00+00:00,179,42,221,22,1.027
2017-01-01 12:00:00+00:00,161,48,209,20,1.231
2017-01-01 13:00:00+00:00,114,43,157,20,0.74
2017-01-01 14:00:00+00:00,55,54,109,23,-0.737
2017-01-01 15:00:00+00:00,17,60,77,31,-2.081
2017-01-01 16:00:00+00:00,8,56,64,38,-2.705
2017-01-01 17:00:00+00:00,8,42,50,38,-3.195
2017-01-01 18:00:00+00:00,0,36,36,37,-3.579
2017-01-01 19:00:00+00:00,0,36,36,32,-3.9
2017-01-01 20:00:00+00:00,0,34,34,30,-4.265
2017-01-01 21:00:00+00:00,0,43,43,31,-4.509
2017-01-01 22:00:00+00:00,0,43,43,24,-4.555
2017-01-01 23:00:00+00:00,0,48,48,26,-4.602
2017-01-02 00:00:00+00:00,0,56,56,24,-4.741
2017-01-02 01:00:00+00:00,0,52,52,23,-4.982
2017-01-02 02:00:00+00:00,0,62,62,22,-5.312
2017-01-02 03:00:00+00:00,0,74,74,24,-5.672
2017-01-02 04:00:00+00:00,0,76,76,27,-6.003
2017-01-02 05:00:00+00:00,0,104,104,33,-6.264
2017-01-02 06:00:00+00:00,8,111,119,45,-6.521
2017-01-02 07:00:00+00:00,17,111,128,42,-6.257
2017-01-02 08:00:00+00:00,54,111,165,47,-4.739
2017-01-02 09:00:00+00:00,102,105,207,49,-2.607
2017-01-02 10:00:00+00:00,140,109,249,51,-1.254
2017-01-02 11:00:00+00:00,155,102,257,50,-0.174
2017-01-02 12:00:00+00:00,138,120,258,52,0.097
2017-01-02 13:00:00+00:00,97,170,267,49,-0.589
2017-01-02 14:00:00+00:00,47,312,359,52,-2.698
2017-01-02 15:00:00+00:00,15,640,655,61,-4.744
2017-01-02 16:00:00+00:00,8,989,997,70,-4.916
2017-01-02 17:00:00+00:00,8,1272,1280,62,-4.937
2017-01-02 18:00:00+00:00,0,1650,1650,56,-5.081
2017-01-02 19:00:00+00:00,0,1670,1670,49,-5.252
2017-01-02 20:00:00+00:00,0,1558,1558,42,-5.579
2017-01-02 21:00:00+00:00,0,1415,1415,41,-5.914
2017-01-02 22:00:00+00:00,0,1259,1259,34,-6.324
2017-01-02 23:00:00+00:00,0,1276,1276,35,-6.842
2017-01-03 00:00:00+00:00,0,1355,1355,36,-7.108
2017-01-03 01:00:00+00:00,0,1527,1527,33,-7.354
2017-01-03 02:00:00+00:00,0,1793,1793,33,-7.79
2017-01-03 03:00:00+00:00,0,1727,1727,31,-8.347
2017-01-03 04:00:00+00:00,0,1532,1532,32,-8.824
2017-01-03 05:00:00+00:00,0,1374,1374,39,-9.002
2017-01-03 06:00:00+00:00,8,1438,1446,51,-9.413
2017-01-03 07:00:00+00:00,16,1437,1453,47,-9.092
2017-01-03 08:00:00+00:00,49,1401,1450,46,-7.535
2017-01-03 09:00:00+00:00,95,1548,1643,45,-6.51
2017-01-03 10:00:00+00:00,132,1610,1742,44,-5.55
2017-01-03 11:00:00+00:00,148,1688,1836,39,-4.834
2017-01-03 12:00:00+00:00,133,1900,2033,37,-4.55
2017-01-03 13:00:00+00:00,94,1955,2049,39,-4.836
2017-01-03 14:00:00+00:00,46,1993,2039,41,-6.118
2017-01-03 15:00:00+00:00,16,1889,1905,40,-8.31
2017-01-03 16:00:00+00:00,8,1666,1674,42,-9.235
2017-01-03 17:00:00+00:00,8,1575,1583,40,-10.068
2017-01-03 18:00:00+00:00,0,1504,1504,37,-10.823
2017-01-03 19:00:00+00:00,0,1478,1478,31,-11.449
2017-01-03 20:00:00+00:00,0,1351,1351,27,-11.776
2017-01-03 21:00:00+00:00,0,1348,1348,25,-11.914
2017-01-03 22:00:00+00:00,0,1224,1224,16,-11.717
2017-01-03 23:00:00+00:00,0,1218,1218,7,-11.391
2017-01-04 00:00:00+00:00,0,1194,1194,4,-10.925
2017-01-04 01:00:00+00:00,0,1255,1255,-2,-10.182
2017-01-04 02:00:00+00:00,0,1419,1419,-1,-9.679
2017-01-04 03:00:00+00:00,0,1880,1880,5,-9.764
2017-01-04 04:00:00+00:00,0,2061,2061,10,-9.892
2017-01-04 05:00:00+00:00,0,2098,2098,23,-9.761
2017-01-04 06:00:00+00:00,8,2022,2030,31,-9.261
2017-01-04 07:00:00+00:00,14,2031,2045,33,-7.861
2017-01-04 08:00:00+00:00,36,2219,2255,34,-5.188
2017-01-04 09:00:00+00:00,68,2365,2433,35,-3.589
2017-01-04 10:00:00+00:00,93,2315,2408,34,-2.837
2017-01-04 11:00:00+00:00,104,2225,2329,34,-2.629
2017-01-04 12:00:00+00:00,95,2370,2465,33,-2.986
2017-01-04 13:00:00+00:00,69,2429,2498,36,-3.614
2017-01-04 14:00:00+00:00,36,2465,2501,38,-4.519
2017-01-04 15:00:00+00:00,14,2456,2470,53,-5.509
2017-01-04 16:00:00+00:00,8,2433,2441,55,-6.048
2017-01-04 17:00:00+00:00,8,2443,2451,52,-6.369
2017-01-04 18:00:00+00:00,0,2432,2432,50,-6.669
2017-01-04 19:00:00+00:00,0,2424,2424,42,-6.98
2017-01-04 20:00:00+00:00,0,2357,2357,39,-7.221
2017-01-04 21:00:00+00:00,0,2293,2293,37,-7.436
2017-01-04 22:00:00+00:00,0,2263,2263,34,-7.617
2017-01-04 23:00:00+00:00,0,2177,2177,34,-7.173
2017-01-05 00:00:00+00:00,0,1860,1860,33,-6.887
2017-01-05 01:00:00+00:00,0,1805,1805,31,-7.161
2017-01-05 02:00:00+00:00,0,1391,1391,31,-7.728
2017-01-05 03:00:00+00:00,0,1207,1207,33,-8.314
2017-01-05 04:00:00+00:00,0,1508,1508,37,-9.28
2017-01-05 05:00:00+00:00,0,1584,1584,43,-10.295
2017-01-05 06:00:00+00:00,8,1599,1607,56,-10.737
2017-01-05 07:00:00+00:00,13,1803,1816,59,-10.644
2017-01-05 08:00:00+00:00,32,2002,2034,57,-10.217
2017-01-05 09:00:00+00:00,57,2188,2245,54,-9.803
2017-01-05 10:00:00+00:00,74,2291,2365,53,-9.532
2017-01-05 11:00:00+00:00,81,2298,2379,52,-9.448
2017-01-05 12:00:00+00:00,78,2318,2396,52,-9.538
2017-01-05 13:00:00+00:00,61,2309,2370,52,-9.832
2017-01-05 14:00:00+00:00,32,2247,2279,55,-10.378
2017-01-05 15:00:00+00:00,13,2120,2133,63,-10.886
2017-01-05 16:00:00+00:00,8,2157,2165,74,-11.203
2017-01-05 17:00:00+00:00,8,2195,2203,69,-11.492
2017-01-05 18:00:00+00:00,0,2166,2166,66,-11.676
2017-01-05 19:00:00+00:00,0,2161,2161,57,-11.914
2017-01-05 20:00:00+00:00,0,2093,2093,49,-12.061
2017-01-05 21:00:00+00:00,0,2097,2097,48,-12.224
2017-01-05 22:00:00+00:00,0,2200,2200,41,-12.552
2017-01-05 23:00:00+00:00,0,2269,2269,44,-13.034
2017-01-06 00:00:00+00:00,0,2301,2301,41,-13.657
2017-01-06 01:00:00+00:00,0,2266,2266,39,-14.211
2017-01-06 02:00:00+00:00,0,2279,2279,38,-14.737
2017-01-06 03:00:00+00:00,0,2310,2310,39,-15.119
2017-01-06 04:00:00+00:00,0,2293,2293,40,-15.439
2017-01-06 05:00:00+00:00,0,2286,2286,49,-15.677
2017-01-06 06:00:00+00:00,8,2350,2358,59,-15.82
2017-01-06 07:00:00+00:00,12,2381,2393,60,-15.789
2017-01-06 08:00:00+00:00,35,2407,2442,59,-15.446
2017-01-06 09:00:00+00:00,69,2389,2458,58,-15.138
2017-01-06 10:00:00+00:00,92,2398,2490,56,-14.867
2017-01-06 11:00:00+00:00,96,2309,2405,55,-14.684
2017-01-06 12:00:00+00:00,83,2220,2303,53,-14.664
2017-01-06 13:00:00+00:00,60,2064,2124,53,-14.854
2017-01-06 14:00:00+00:00,31,1972,2003,57,-15.262
2017-01-06 15:00:00+00:00,12,2081,2093,65,-15.765
2017-01-06 16:00:00+00:00,8,2052,2060,71,-15.923
2017-01-06 17:00:00+00:00,8,1912,1920,67,-15.974
2017-01-06 18:00:00+00:00,0,1785,1785,61,-16.123
2017-01-06 19:00:00+00:00,0,1536,1536,51,-16.169
2017-01-06 20:00:00+00:00,0,1560,1560,40,-16.467
2017-01-06 21:00:00+00:00,0,1474,1474,39,-16.907
2017-01-06 22:00:00+00:00,0,1496,1496,35,-16.979
2017-01-06 23:00:00+00:00,0,1546,1546,40,-17.186
2017-01-07 00:00:00+00:00,0,1625,1625,37,-17.404
2017-01-07 01:00:00+00:00,0,1597,1597,35,-17.653
2017-01-07 02:00:00+00:00,0,1554,1554,34,-18.11
2017-01-07 03:00:00+00:00,0,1415,1415,33,-18.863
2017-01-07 04:00:00+00:00,0,1403,1403,33,-19.403
2017-01-07 05:00:00+00:00,0,1522,1522,30,-20.016
2017-01-07 06:00:00+00:00,8,1634,1642,34,-20.278
2017-01-07 07:00:00+00:00,13,1727,1740,36,-19.656
2017-01-07 08:00:00+00:00,41,1673,1714,40,-17.33
2017-01-07 09:00:00+00:00,85,1674,1759,41,-14.071
2017-01-07 10:00:00+00:00,121,1669,1790,43,-12.032
2017-01-07 11:00:00+00:00,134,1677,1811,44,-10.929
2017-01-07 12:00:00+00:00,118,1665,1783,41,-10.508
2017-01-07 13:00:00+00:00,80,1397,1477,43,-10.518
2017-01-07 14:00:00+00:00,39,886,925,46,-11.041
2017-01-07 15:00:00+00:00,14,659,673,51,-12.163
2017-01-07 16:00:00+00:00,8,626,634,56,-12.81
2017-01-07 17:00:00+00:00,8,580,588,56,-12.929
2017-01-07 18:00:00+00:00,0,466,466,51,-12.65
2017-01-07 19:00:00+00:00,0,311,311,45,-12.44
2017-01-07 20:00:00+00:00,0,352,352,43,-12.177
2017-01-07 21:00:00+00:00,0,358,358,44,-12.017
2017-01-07 22:00:00+00:00,0,347,347,38,-11.812
2017-01-07 23:00:00+00:00,0,315,315,38,-11.559
2017-01-08 00:00:00+00:00,0,278,278,37,-11.451
2017-01-08 01:00:00+00:00,0,208,208,35,-11.516
2017-01-08 02:00:00+00:00,0,153,153,33,-11.52
2017-01-08 03:00:00+00:00,0,122,122,33,-11.357
2017-01-08 04:00:00+00:00,0,116,116,36,-11.033
2017-01-08 05:00:00+00:00,0,126,126,35,-10.805
2017-01-08 06:00:00+00:00,8,151,159,38,-10.521
2017-01-08 07:00:00+00:00,10,191,201,38,-10.11
2017-01-08 08:00:00+00:00,26,207,233,43,-9.103
2017-01-08 09:00:00+00:00,50,231,281,47,-8.217
2017-01-08 10:00:00+00:00,70,323,393,48,-7.534
2017-01-08 11:00:00+00:00,79,467,546,47,-7.097
2017-01-08 12:00:00+00:00,74,665,739,44,-6.959
2017-01-08 13:00:00+00:00,57,993,1050,42,-7.071
2017-01-08 14:00:00+00:00,32,1116,1148,44,-7.497
2017-01-08 15:00:00+00:00,13,1388,1401,47,-8.383
2017-01-08 16:00:00+00:00,8,1565,1573,55,-9.222
2017-01-08 17:00:00+00:00,8,1566,1574,55,-9.737
2017-01-08 18:00:00+00:00,0,1652,1652,54,-10.13
2017-01-08 19:00:00+00:00,0,1619,1619,49,-10.248
2017-01-08 20:00:00+00:00,0,1647,1647,44,-10.317
2017-01-08 21:00:00+00:00,0,1600,1600,45,-10.325
2017-01-08 22:00:00+00:00,0,1500,1500,39,-10.104
2017-01-08 23:00:00+00:00,0,1534,1534,39,-10.002
2017-01-09 00:00:00+00:00,0,1501,1501,38,-10.121
2017-01-09 01:00:00+00:00,0,1558,1558,37,-10.235
2017-01-09 02:00:00+00:00,0,1614,1614,35,-10.511
2017-01-09 03:00:00+00:00,0,1652,1652,37,-10.787
2017-01-09 04:00:00+00:00,0,1666,1666,39,-10.902
2017-01-09 05:00:00+00:00,0,1580,1580,47,-10.709
2017-01-09 06:00:00+00:00,8,1673,1681,65,-10.808
2017-01-09 07:00:00+00:00,13,1678,1691,66,-10.729
2017-01-09 08:00:00+00:00,34,1689,1723,69,-9.334
2017-01-09 09:00:00+00:00,65,1539,1604,69,-8.19
2017-01-09 10:00:00+00:00,91,1482,1573,67,-7.338
2017-01-09 11:00:00+00:00,102,1462,1564,65,-6.744
2017-01-09 12:00:00+00:00,93,1404,1497,64,-6.552
2017-01-09 13:00:00+00:00,69,1346,1415,62,-6.807
2017-01-09 14:00:00+00:00,38,1439,1477,59,-7.435
2017-01-09 15:00:00+00:00,15,1391,1406,60,-8.809
2017-01-09 16:00:00+00:00,8,1218,1226,64,-9.709
2017-01-09 17:00:00+00:00,8,1105,1113,58,-10.122
2017-01-09 18:00:00+00:00,0,937,937,56,-10.539
2017-01-09 19:00:00+00:00,0,542,542,45,-10.841
2017-01-09 20:00:00+00:00,0,196,196,39,-10.962
2017-01-09 21:00:00+00:00,0,112,112,37,-11.047
2017-01-09 22:00:00+00:00,0,63,63,32,-11.258
2017-01-09 23:00:00+00:00,0,29,29,33,-11.615
2017-01-10 00:00:00+00:00,0,22,22,32,-12.045
2017-01-10 01:00:00+00:00,0,50,50,30,-12.394
2017-01-10 02:00:00+00:00,0,223,223,29,-12.853
2017-01-10 03:00:00+00:00,0,425,425,30,-13.484
2017-01-10 04:00:00+00:00,0,586,586,34,-14.116
2017-01-10 05:00:00+00:00,0,553,553,40,-14.64
2017-01-10 06:00:00+00:00,8,450,458,58,-15.178
2017-01-10 07:00:00+00:00,11,482,493,60,-15.26
2017-01-10 08:00:00+00:00,30,493,523,60,-13.297
2017-01-10 09:00:00+00:00,63,537,600,61,-9.24
2017-01-10 10:00:00+00:00,90,641,731,62,-7.013
2017-01-10 11:00:00+00:00,101,847,948,62,-5.667
2017-01-10 12:00:00+00:00,91,899,990,62,-5.115
2017-01-10 13:00:00+00:00,65,874,939,62,-5.332
2017-01-10 14:00:00+00:00,33,858,891,64,-6.738
2017-01-10 15:00:00+00:00,13,882,895,66,-8.711
2017-01-10 16:00:00+00:00,8,925,933,76,-10.268
2017-01-10 17:00:00+00:00,8,944,952,69,-11.249
2017-01-10 18:00:00+00:00,0,906,906,61,-11.723
2017-01-10 19:00:00+00:00,0,960,960,53,-11.893
2017-01-10 20:00:00+00:00,0,1032,1032,45,-11.827
2017-01-10 21:00:00+00:00,0,964,964,42,-11.596
2017-01-10 22:00:00+00:00,0,1012,1012,37,-11.332
2017-01-10 23:00:00+00:00,0,1027,1027,37,-11.183
2017-01-11 00:00:00+00:00,0,1167,1167,35,-11.024
2017-01-11 01:00:00+00:00,0,1148,1148,34,-10.962
2017-01-11 02:00:00+00:00,0,1049,1049,33,-10.963
2017-01-11 03:00:00+00:00,0,665,665,33,-10.937
2017-01-11 04:00:00+00:00,0,392,392,34,-10.989
2017-01-11 05:00:00+00:00,0,349,349,40,-11.016
2017-01-11 06:00:00+00:00,8,343,351,59,-11.084
2017-01-11 07:00:00+00:00,11,303,314,45,-10.93
2017-01-11 08:00:00+00:00,29,244,273,44,-9.586
2017-01-11 09:00:00+00:00,59,270,329,41,-6.933
2017-01-11 10:00:00+00:00,85,468,553,41,-5.378
2017-01-11 11:00:00+00:00,96,462,558,38,-4.603
2017-01-11 12:00:00+00:00,89,471,560,38,-4.262
2017-01-11 13:00:00+00:00,66,572,638,36,-4.343
2017-01-11 14:00:00+00:00,36,762,798,36,-5.303
2017-01-11 15:00:00+00:00,14,1152,1166,36,-6.918
2017-01-11 16:00:00+00:00,8,1515,1523,43,-8.163
2017-01-11 17:00:00+00:00,8,1506,1514,41,-8.957
2017-01-11 18:00:00+00:00,0,1540,1540,36,-9.467
2017-01-11 19:00:00+00:00,0,1374,1374,34,-9.563
2017-01-11 20:00:00+00:00,0,1285,1285,29,-9.233
2017-01-11 21:00:00+00:00,0,1200,1200,26,-7.327
2017-01-11 22:00:00+00:00,0,926,926,18,-5.744
2017-01-11 23:00:00+00:00,0,818,818,11,-5.147
2017-01-12 00:00:00+00:00,0,610,610,8,-4.615
2017-01-12 01:00:00+00:00,0,543,543,6,-4.367
2017-01-12 02:00:00+00:00,0,540,540,6,-4.182
2017-01-12 03:00:00+00:00,0,641,641,9,-4.105
2017-01-12 04:00:00+00:00,0,794,794,14,-4.106
2017-01-12 05:00:00+00:00,0,905,905,30,-4.125
2017-01-12 06:00:00+00:00,8,1035,1043,43,-4.157
2017-01-12 07:00:00+00:00,14,1284,1298,41,-3.956
2017-01-12 08:00:00+00:00,37,1069,1106,41,-3.092
2017-01-12 09:00:00+00:00,69,984,1053,41,-2.312
2017-01-12 10:00:00+00:00,95,976,1071,41,-1.753
2017-01-12 11:00:00+00:00,105,726,831,39,-1.314
2017-01-12 12:00:00+00:00,97,695,792,38,-1.068
2017-01-12 13:00:00+00:00,71,701,772,39,-1.081
2017-01-12 14:00:00+00:00,39,685,724,43,-1.909
2017-01-12 15:00:00+00:00,15,597,612,47,-3.578
2017-01-12 16:00:00+00:00,8,491,499,55,-4.7
2017-01-12 17:00:00+00:00,8,483,491,55,-5.622
2017-01-12 18:00:00+00:00,0,568,568,50,-5.988
2017-01-12 19:00:00+00:00,0,605,605,46,-5.515
2017-01-12 20:00:00+00:00,0,740,740,41,-5.394
2017-01-12 21:00:00+00:00,0,1020,1020,39,-5.439
2017-01-12 22:00:00+00:00,0,1300,1300,34,-5.702
2017-01-12 23:00:00+00:00,0,1701,1701,36,-5.92
2017-01-13 00:00:00+00:00,0,1972,1972,33,-5.835
2017-01-13 01:00:00+00:00,0,2083,2083,29,-5.346
2017-01-13 02:00:00+00:00,0,1894,1894,28,-5.333
2017-01-13 03:00:00+00:00,0,1743,1743,31,-5.403
2017-01-13 04:00:00+00:00,0,1768,1768,31,-5.688
2017-01-13 05:00:00+00:00,0,1557,1557,39,-5.933
2017-01-13 06:00:00+00:00,8,1148,1156,51,-5.784
2017-01-13 07:00:00+00:00,14,791,805,53,-6.491
2017-01-13 08:00:00+00:00,32,830,862,48,-5.139
2017-01-13 09:00:00+00:00,58,1006,1064,47,-5.005
2017-01-13 10:00:00+00:00,79,1386,1465,47,-5.658
2017-01-13 11:00:00+00:00,87,1314,1401,43,-6.3
2017-01-13 12:00:00+00:00,79,1363,1442,41,-6.984
2017-01-13 13:00:00+00:00,58,1352,1410,41,-7.616
2017-01-13 14:00:00+00:00,32,1513,1545,42,-8.088
2017-01-13 15:00:00+00:00,13,1827,1840,45,-8.352
2017-01-13 16:00:00+00:00,8,2097,2105,52,-8.409
2017-01-13 17:00:00+00:00,8,2166,2174,52,-8.401
2017-01-13 18:00:00+00:00,0,2308,2308,48,-8.372
2017-01-13 19:00:00+00:00,0,2342,2342,40,-8.318
2017-01-13 20:00:00+00:00,0,2203,2203,36,-8.277
2017-01-13 21:00:00+00:00,0,2270,2270,34,-8.262
2017-01-13 22:00:00+00:00,0,2406,2406,28,-8.334
2017-01-13 23:00:00+00:00,0,2427,2427,30,-8.743
2017-01-14 00:00:00+00:00,0,2366,2366,28,-9.342
2017-01-14 01:00:00+00:00,0,2312,2312,26,-10.265
2017-01-14 02:00:00+00:00,0,2384,2384,24,-11.787
2017-01-14 03:00:00+00:00,0,2230,2230,24,-13.296
2017-01-14 04:00:00+00:00,0,1868,1868,24,-14.57
2017-01-14 05:00:00+00:00,0,1614,1614,23,-14.662
2017-01-14 06:00:00+00:00,8,1139,1147,28,-13.999
2017-01-14 07:00:00+00:00,14,514,528,33,-12.077
2017-01-14 08:00:00+00:00,36,284,320,37,-9.129
2017-01-14 09:00:00+00:00,62,332,394,37,-6.504
2017-01-14 10:00:00+00:00,77,456,533,38,-5.545
2017-01-14 11:00:00+00:00,84,599,683,36,-5.313
2017-01-14 12:00:00+00:00,80,956,1036,35,-5.493
2017-01-14 13:00:00+00:00,63,1316,1379,33,-5.877
2017-01-14 14:00:00+00:00,37,1778,1815,34,-6.465
2017-01-14 15:00:00+00:00,15,2033,2048,41,-7.391
2017-01-14 16:00:00+00:00,8,1891,1899,44,-8.308
2017-01-14 17:00:00+00:00,8,1980,1988,44,-8.91
2017-01-14 18:00:00+00:00,0,1618,1618,40,-9.326
2017-01-14 19:00:00+00:00,0,1509,1509,35,-9.716
2017-01-14 20:00:00+00:00,0,1484,1484,32,-10.097
2017-01-14 21:00:00+00:00,0,1279,1279,34,-10.687
2017-01-14 22:00:00+00:00,0,1241,1241,31,-11.153
2017-01-14 23:00:00+00:00,0,1070,1070,28,-11.398
2017-01-15 00:00:00+00:00,0,1163,1163,27,-11.475
2017-01-15 01:00:00+00:00,0,1098,1098,27,-11.558
2017-01-15 02:00:00+00:00,0,1081,1081,26,-11.917
2017-01-15 03:00:00+00:00,0,1107,1107,27,-12.312
2017-01-15 04:00:00+00:00,0,1130,1130,28,-12.773
2017-01-15 05:00:00+00:00,0,1213,1213,29,-13.259
2017-01-15 06:00:00+00:00,8,1118,1126,31,-13.652
2017-01-15 07:00:00+00:00,14,994,1008,36,-13.536
2017-01-15 08:00:00+00:00,40,889,929,39,-11.687
2017-01-15 09:00:00+00:00,82,1075,1157,41,-8.753
2017-01-15 10:00:00+00:00,117,1146,1263,45,-8.098
2017-01-15 11:00:00+00:00,130,1121,1251,43,-7.912
2017-01-15 12:00:00+00:00,117,1134,1251,40,-7.924
2017-01-15 13:00:00+00:00,85,904,989,40,-8.132
2017-01-15 14:00:00+00:00,48,914,962,41,-9.084
2017-01-15 15:00:00+00:00,18,871,889,48,-10.84
2017-01-15 16:00:00+00:00,8,819,827,54,-11.474
2017-01-15 17:00:00+00:00,8,841,849,59,-11.615
2017-01-15 18:00:00+00:00,0,684,684,56,-11.762
2017-01-15 19:00:00+00:00,0,556,556,48,-11.993
2017-01-15 20:00:00+00:00,0,459,459,42,-12.081
2017-01-15 21:00:00+00:00,0,398,398,44,-12.168
2017-01-15 22:00:00+00:00,0,331,331,38,-12.298
2017-01-15 23:00:00+00:00,0,305,305,38,-12.409
2017-01-16 00:00:00+00:00,0,321,321,37,-12.476
2017-01-16 01:00:00+00:00,0,382,382,37,-12.555
2017-01-16 02:00:00+00:00,0,365,365,36,-12.868
2017-01-16 03:00:00+00:00,0,321,321,37,-13.212
2017-01-16 04:00:00+00:00,0,253,253,39,-13.454
2017-01-16 05:00:00+00:00,0,153,153,52,-13.5
2017-01-16 06:00:00+00:00,8,97,105,77,-13.372
2017-01-16 07:00:00+00:00,14,77,91,89,-12.962
2017-01-16 08:00:00+00:00,38,74,112,85,-11.526
2017-01-16 09:00:00+00:00,78,58,136,85,-9.738
2017-01-16 10:00:00+00:00,109,34,143,82,-9.494
2017-01-16 11:00:00+00:00,114,53,167,78,-9.322
2017-01-16 12:00:00+00:00,103,91,194,71,-9.248
2017-01-16 13:00:00+00:00,78,113,191,69,-9.292
2017-01-16 14:00:00+00:00,43,155,198,71,-9.517
2017-01-16 15:00:00+00:00,16,268,284,71,-10.31
2017-01-16 16:00:00+00:00,8,419,427,109,-11.24
2017-01-16 17:00:00+00:00,8,541,549,95,-11.347
2017-01-16 18:00:00+00:00,0,576,576,85,-11.538
2017-01-16 19:00:00+00:00,0,651,651,71,-11.857
2017-01-16 20:00:00+00:00,0,733,733,52,-12.106
2017-01-16 21:00:00+00:00,0,816,816,50,-12.283
2017-01-16 22:00:00+00:00,0,938,938,40,-12.407
2017-01-16 23:00:00+00:00,0,1006,1006,46,-12.603
2017-01-17 00:00:00+00:00,0,1119,1119,45,-12.828
2017-01-17 01:00:00+00:00,0,1290,1290,41,-13.084
2017-01-17 02:00:00+00:00,0,1394,1394,41,-12.926
2017-01-17 03:00:00+00:00,0,1358,1358,40,-12.402
2017-01-17 04:00:00+00:00,0,1325,1325,41,-12.285
2017-01-17 05:00:00+00:00,0,1396,1396,68,-12.264
2017-01-17 06:00:00+00:00,8,1474,1482,101,-12.355
2017-01-17 07:00:00+00:00,13,1463,1476,126,-12.183
2017-01-17 08:00:00+00:00,32,1459,1491,119,-11.121
2017-01-17 09:00:00+00:00,60,1427,1487,112,-10.547
2017-01-17 10:00:00+00:00,84,1218,1302,111,-10.206
2017-01-17 11:00:00+00:00,94,1085,1179,106,-9.927
2017-01-17 12:00:00+00:00,87,1090,1177,101,-9.816
2017-01-17 13:00:00+00:00,66,1262,1328,101,-10.002
2017-01-17 14:00:00+00:00,38,1368,1406,106,-10.522
2017-01-17 15:00:00+00:00,15,1485,1500,110,-11.493
2017-01-17 16:00:00+00:00,8,1588,1596,133,-12.405
2017-01-17 17:00:00+00:00,8,1570,1578,119,-12.696
2017-01-17 18:00:00+00:00,0,1496,1496,110,-12.995
2017-01-17 19:00:00+00:00,0,1421,1421,76,-13.365
2017-01-17 20:00:00+00:00,0,1562,1562,60,-13.694
2017-01-17 21:00:00+00:00,0,1534,1534,50,-14.497
2017-01-17 22:00:00+00:00,0,1448,1448,38,-15.403
2017-01-17 23:00:00+00:00,0,1412,1412,41,-15.972
2017-01-18 00:00:00+00:00,0,1342,1342,39,-16.287
2017-01-18 01:00:00+00:00,0,1300,1300,37,-16.517
2017-01-18 02:00:00+00:00,0,1222,1222,36,-16.711
2017-01-18 03:00:00+00:00,0,1255,1255,37,-16.658
2017-01-18 04:00:00+00:00,0,1196,1196,39,-16.608
2017-01-18 05:00:00+00:00,0,987,987,58,-16.676
2017-01-18 06:00:00+00:00,8,833,841,101,-16.744
2017-01-18 07:00:00+00:00,13,708,721,115,-16.32
2017-01-18 08:00:00+00:00,36,531,567,117,-14.007
2017-01-18 09:00:00+00:00,68,479,547,109,-11.222
2017-01-18 10:00:00+00:00,93,478,571,107,-9.49
2017-01-18 11:00:00+00:00,106,451,557,97,-8.288
2017-01-18 12:00:00+00:00,98,426,524,95,-7.701
2017-01-18 13:00:00+00:00,71,427,498,94,-7.679
2017-01-18 14:00:00+00:00,40,444,484,99,-8.627
2017-01-18 15:00:00+00:00,16,503,519,105,-11.006
2017-01-18 16:00:00+00:00,8,615,623,130,-12.408
2017-01-18 17:00:00+00:00,8,662,670,130,-13.093
2017-01-18 18:00:00+00:00,0,600,600,114,-13.684
2017-01-18 19:00:00+00:00,0,593,593,80,-14.389
2017-01-18 20:00:00+00:00,0,672,672,54,-14.971
2017-01-18 21:00:00+00:00,0,758,758,49,-15.229
2017-01-18 22:00:00+00:00,0,738,738,39,-15.381
2017-01-18 23:00:00+00:00,0,561,561,41,-15.541
2017-01-19 00:00:00+00:00,0,386,386,40,-15.716
2017-01-19 01:00:00+00:00,0,413,413,38,-15.701
2017-01-19 02:00:00+00:00,0,423,423,36,-15.615
2017-01-19 03:00:00+00:00,0,370,370,37,-15.438
2017-01-19 04:00:00+00:00,0,359,359,39,-15.147
2017-01-19 05:00:00+00:00,0,429,429,55,-14.912
2017-01-19 06:00:00+00:00,8,493,501,92,-14.777
2017-01-19 07:00:00+00:00,13,407,420,98,-13.978
2017-01-19 08:00:00+00:00,36,243,279,93,-10.954
2017-01-19 09:00:00+00:00,75,118,193,90,-7.135
2017-01-19 10:00:00+00:00,110,72,182,92,-5.508
2017-01-19 11:00:00+00:00,126,57,183,88,-4.519
2017-01-19 12:00:00+00:00,116,61,177,89,-4.12
2017-01-19 13:00:00+00:00,85,51,136,87,-4.249
2017-01-19 14:00:00+00:00,47,55,102,94,-5.451
2017-01-19 15:00:00+00:00,17,76,93,97,-7.758
2017-01-19 16:00:00+00:00,8,118,126,117,-9.566
2017-01-19 17:00:00+00:00,8,113,121,110,-10.959
2017-01-19 18:00:00+00:00,0,71,71,97,-12.003
2017-01-19 19:00:00+00:00,0,52,52,82,-12.822
2017-01-19 20:00:00+00:00,0,50,50,58,-13.545
2017-01-19 21:00:00+00:00,0,49,49,51,-14.199
2017-01-19 22:00:00+00:00,0,49,49,45,-14.666
2017-01-19 23:00:00+00:00,0,44,44,39,-14.863
2017-01-20 00:00:00+00:00,0,41,41,39,-14.894
2017-01-20 01:00:00+00:00,0,44,44,37,-14.888
2017-01-20 02:00:00+00:00,0,50,50,36,-14.907
2017-01-20 03:00:00+00:00,0,52,52,38,-14.872
2017-01-20 04:00:00+00:00,0,55,55,40,-14.85
2017-01-20 05:00:00+00:00,0,62,62,56,-14.852
2017-01-20 06:00:00+00:00,8,66,74,90,-14.83
2017-01-20 07:00:00+00:00,14,66,80,95,-13.908
2017-01-20 08:00:00+00:00,39,60,99,88,-10.354
2017-01-20 09:00:00+00:00,81,58,139,84,-6.727
2017-01-20 10:00:00+00:00,119,59,178,80,-4.952
2017-01-20 11:00:00+00:00,136,63,199,81,-3.835
2017-01-20 12:00:00+00:00,126,70,196,75,-3.205
2017-01-20 13:00:00+00:00,92,71,163,73,-3.147
2017-01-20 14:00:00+00:00,51,105,156,72,-4.233
2017-01-20 15:00:00+00:00,18,165,183,75,-7.037
2017-01-20 16:00:00+00:00,8,192,200,92,-9.03
2017-01-20 17:00:00+00:00,8,191,199,92,-10.282
2017-01-20 18:00:00+00:00,0,209,209,78,-11.183
2017-01-20 19:00:00+00:00,0,195,195,68,-11.829
2017-01-20 20:00:00+00:00,0,209,209,54,-12.326
2017-01-20 21:00:00+00:00,0,246,246,52,-12.721
2017-01-20 22:00:00+00:00,0,272,272,47,-12.957
2017-01-20 23:00:00+00:00,0,264,264,49,-13.05
2017-01-21 00:00:00+00:00,0,216,216,45,-13.035
2017-01-21 01:00:00+00:00,0,176,176,44,-13.003
2017-01-21 02:00:00+00:00,0,166,166,42,-12.956
2017-01-21 03:00:00+00:00,0,156,156,41,-12.955
2017-01-21 04:00:00+00:00,0,188,188,41,-12.935
2017-01-21 05:00:00+00:00,0,212,212,40,-12.79
2017-01-21 06:00:00+00:00,8,199,207,46,-12.518
2017-01-21 07:00:00+00:00,14,173,187,51,-11.578
2017-01-21 08:00:00+00:00,37,138,175,55,-9.247
2017-01-21 09:00:00+00:00,77,85,162,57,-5.486
2017-01-21 10:00:00+00:00,113,53,166,57,-3.316
2017-01-21 11:00:00+00:00,131,74,205,53,-2.33
2017-01-21 12:00:00+00:00,122,136,258,49,-1.566
2017-01-21 13:00:00+00:00,91,168,259,48,-1.505
2017-01-21 14:00:00+00:00,51,205,256,51,-2.383
2017-01-21 15:00:00+00:00,19,226,245,61,-4.433
2017-01-21 16:00:00+00:00,8,239,247,69,-6.309
2017-01-21 17:00:00+00:00,8,283,291,72,-7.795
2017-01-21 18:00:00+00:00,0,340,340,63,-9.098
2017-01-21 19:00:00+00:00,0,409,409,51,-10.208
2017-01-21 20:00:00+00:00,0,480,480,45,-11.116
2017-01-21 21:00:00+00:00,0,570,570,48,-11.761
2017-01-21 22:00:00+00:00,0,644,644,44,-12.276
2017-01-21 23:00:00+00:00,0,651,651,40,-12.226
2017-01-22 00:00:00+00:00,0,661,661,39,-11.879
2017-01-22 01:00:00+00:00,0,737,737,39,-11.944
2017-01-22 02:00:00+00:00,0,731,731,37,-11.928
2017-01-22 03:00:00+00:00,0,753,753,37,-11.931
2017-01-22 04:00:00+00:00,0,950,950,37,-12.002
2017-01-22 05:00:00+00:00,0,1084,1084,35,-12.095
2017-01-22 06:00:00+00:00,8,1159,1167,37,-12.234
2017-01-22 07:00:00+00:00,15,1132,1147,40,-11.322
2017-01-22 08:00:00+00:00,40,1057,1097,42,-8.573
2017-01-22 09:00:00+00:00,79,1097,1176,44,-5.547
2017-01-22 10:00:00+00:00,115,1222,1337,46,-3.897
2017-01-22 11:00:00+00:00,133,1361,1494,43,-2.799
2017-01-22 12:00:00+00:00,124,1391,1515,38,-2.194
2017-01-22 13:00:00+00:00,93,1414,1507,37,-2.161
2017-01-22 14:00:00+00:00,53,1364,1417,38,-3.193
2017-01-22 15:00:00+00:00,20,1350,1370,48,-5.994
2017-01-22 16:00:00+00:00,8,1375,1383,59,-8.515
2017-01-22 17:00:00+00:00,8,1454,1462,62,-9.784
2017-01-22 18:00:00+00:00,0,1585,1585,58,-10.46
2017-01-22 19:00:00+00:00,0,1675,1675,52,-10.854
2017-01-22 20:00:00+00:00,0,1819,1819,44,-11.203
2017-01-22 21:00:00+00:00,0,1873,1873,46,-11.446
2017-01-22 22:00:00+00:00,0,1767,1767,42,-11.52
2017-01-22 23:00:00+00:00,0,1671,1671,42,-11.622
2017-01-23 00:00:00+00:00,0,1750,1750,40,-11.363
2017-01-23 01:00:00+00:00,0,1634,1634,38,-11.033
2017-01-23 02:00:00+00:00,0,1446,1446,38,-10.778
2017-01-23 03:00:00+00:00,0,1434,1434,35,-10.897
2017-01-23 04:00:00+00:00,0,1389,1389,39,-11.223
2017-01-23 05:00:00+00:00,0,1301,1301,55,-11.443
2017-01-23 06:00:00+00:00,8,1244,1252,81,-11.538
2017-01-23 07:00:00+00:00,13,1150,1163,95,-10.728
2017-01-23 08:00:00+00:00,31,1001,1032,88,-8.278
2017-01-23 09:00:00+00:00,59,891,950,86,-4.828
2017-01-23 10:00:00+00:00,85,720,805,86,-3.17
2017-01-23 11:00:00+00:00,97,588,685,83,-2.243
2017-01-23 12:00:00+00:00,94,496,590,84,-1.545
2017-01-23 13:00:00+00:00,74,377,451,82,-1.459
2017-01-23 14:00:00+00:00,44,209,253,83,-2.174
2017-01-23 15:00:00+00:00,17,140,157,86,-3.58
2017-01-23 16:00:00+00:00,8,77,85,99,-5.236
2017-01-23 17:00:00+00:00,8,46,54,98,-6.423
2017-01-23 18:00:00+00:00,0,27,27,88,-7.237
2017-01-23 19:00:00+00:00,0,23,23,70,-7.709
2017-01-23 20:00:00+00:00,0,19,19,56,-7.694
2017-01-23 21:00:00+00:00,0,20,20,48,-7.704
2017-01-23 22:00:00+00:00,0,11,11,44,-7.98
2017-01-23 23:00:00+00:00,0,6,6,44,-8.331
2017-01-24 00:00:00+00:00,0,7,7,43,-8.772
2017-01-24 01:00:00+00:00,0,6,6,42,-9.288
2017-01-24 02:00:00+00:00,0,4,4,40,-9.763
2017-01-24 03:00:00+00:00,0,5,5,41,-10.026
2017-01-24 04:00:00+00:00,0,10,10,45,-10.12
2017-01-24 05:00:00+00:00,0,13,13,73,-10.161
2017-01-24 06:00:00+00:00,8,31,39,121,-10.192
2017-01-24 07:00:00+00:00,14,57,71,138,-9.673
2017-01-24 08:00:00+00:00,36,77,113,135,-7.952
2017-01-24 09:00:00+00:00,75,91,166,123,-5.651
2017-01-24 10:00:00+00:00,110,136,246,121,-4.411
2017-01-24 11:00:00+00:00,128,225,353,113,-3.545
2017-01-24 12:00:00+00:00,118,357,475,110,-3.228
2017-01-24 13:00:00+00:00,86,426,512,105,-3.594
2017-01-24 14:00:00+00:00,48,437,485,105,-4.887
2017-01-24 15:00:00+00:00,18,505,523,111,-7.564
2017-01-24 16:00:00+00:00,8,594,602,141,-9.386
2017-01-24 17:00:00+00:00,8,693,701,143,-10.634
2017-01-24 18:00:00+00:00,0,755,755,124,-11.897
2017-01-24 19:00:00+00:00,0,812,812,86,-12.998
2017-01-24 20:00:00+00:00,0,867,867,69,-13.81
2017-01-24 21:00:00+00:00,0,886,886,60,-13.902
2017-01-24 22:00:00+00:00,0,890,890,44,-13.441
2017-01-24 23:00:00+00:00,0,765,765,48,-12.899
2017-01-25 00:00:00+00:00,0,661,661,44,-12.416
2017-01-25 01:00:00+00:00,0,650,650,43,-12.104
2017-01-25 02:00:00+00:00,0,700,700,40,-12.029
2017-01-25 03:00:00+00:00,0,660,660,41,-12.044
2017-01-25 04:00:00+00:00,0,632,632,45,-11.825
2017-01-25 05:00:00+00:00,0,583,583,70,-11.584
2017-01-25 06:00:00+00:00,8,565,573,120,-11.416
2017-01-25 07:00:00+00:00,13,491,504,130,-10.517
2017-01-25 08:00:00+00:00,35,346,381,112,-8.05
2017-01-25 09:00:00+00:00,76,211,287,104,-4.849
2017-01-25 10:00:00+00:00,115,147,262,98,-3.298
2017-01-25 11:00:00+00:00,137,129,266,91,-1.999
2017-01-25 12:00:00+00:00,128,91,219,87,-1.687
2017-01-25 13:00:00+00:00,95,65,160,87,-1.976
2017-01-25 14:00:00+00:00,54,53,107,93,-2.977
2017-01-25 15:00:00+00:00,20,67,87,96,-4.825
2017-01-25 16:00:00+00:00,8,66,74,117,-6.678
2017-01-25 17:00:00+00:00,8,71,79,127,-8.133
2017-01-25 18:00:00+00:00,0,57,57,102,-9.173
2017-01-25 19:00:00+00:00,0,35,35,86,-10.125
2017-01-25 20:00:00+00:00,0,31,31,68,-10.971
2017-01-25 21:00:00+00:00,0,24,24,58,-11.18
2017-01-25 22:00:00+00:00,0,27,27,49,-10.821
2017-01-25 23:00:00+00:00,0,37,37,43,-10.429
2017-01-26 00:00:00+00:00,0,35,35,40,-10.023
2017-01-26 01:00:00+00:00,0,36,36,39,-9.755
2017-01-26 02:00:00+00:00,0,58,58,37,-9.561
2017-01-26 03:00:00+00:00,0,82,82,37,-9.923
2017-01-26 04:00:00+00:00,0,107,107,41,-10.716
2017-01-26 05:00:00+00:00,0,136,136,51,-11.389
2017-01-26 06:00:00+00:00,8,172,180,72,-12.021
2017-01-26 07:00:00+00:00,16,228,244,72,-11.69
2017-01-26 08:00:00+00:00,43,245,288,69,-8.736
2017-01-26 09:00:00+00:00,85,246,331,64,-5.244
2017-01-26 10:00:00+00:00,124,225,349,65,-3.779
2017-01-26 11:00:00+00:00,143,246,389,61,-2.673
2017-01-26 12:00:00+00:00,134,376,510,58,-2.506
2017-01-26 13:00:00+00:00,102,428,530,56,-2.828
2017-01-26 14:00:00+00:00,60,523,583,60,-3.596
2017-01-26 15:00:00+00:00,23,684,707,63,-6.1
2017-01-26 16:00:00+00:00,9,988,997,68,-8.42
2017-01-26 17:00:00+00:00,8,1221,1229,60,-9.598
2017-01-26 18:00:00+00:00,0,1454,1454,55,-10.521
2017-01-26 19:00:00+00:00,0,1659,1659,48,-11.436
2017-01-26 20:00:00+00:00,0,1843,1843,41,-11.947
2017-01-26 21:00:00+00:00,0,1946,1946,39,-12.077
2017-01-26 22:00:00+00:00,0,1930,1930,35,-11.918
2017-01-26 23:00:00+00:00,0,1932,1932,36,-11.637
2017-01-27 00:00:00+00:00,0,2007,2007,36,-11.066
2017-01-27 01:00:00+00:00,0,2090,2090,33,-10.554
2017-01-27 02:00:00+00:00,0,2039,2039,33,-10.417
2017-01-27 03:00:00+00:00,0,1943,1943,33,-10.419
2017-01-27 04:00:00+00:00,0,1910,1910,35,-10.269
2017-01-27 05:00:00+00:00,0,1775,1775,39,-9.876
2017-01-27 06:00:00+00:00,8,1723,1731,52,-9.489
2017-01-27 07:00:00+00:00,16,1666,1682,53,-8.532
2017-01-27 08:00:00+00:00,44,1633,1677,50,-5.927
2017-01-27 09:00:00+00:00,88,1595,1683,49,-2.021
2017-01-27 10:00:00+00:00,129,1583,1712,49,-0.73
2017-01-27 11:00:00+00:00,150,1519,1669,48,-0.048
2017-01-27 12:00:00+00:00,141,1326,1467,48,0.207
2017-01-27 13:00:00+00:00,107,1208,1315,47,0.159
2017-01-27 14:00:00+00:00,63,1119,1182,53,-0.288
2017-01-27 15:00:00+00:00,24,1117,1141,59,-1.974
2017-01-27 16:00:00+00:00,9,948,957,64,-4.049
2017-01-27 17:00:00+00:00,8,951,959,63,-5.524
2017-01-27 18:00:00+00:00,0,1090,1090,59,-6.654
2017-01-27 19:00:00+00:00,0,1036,1036,49,-7.57
2017-01-27 20:00:00+00:00,0,979,979,43,-8.5
2017-01-27 21:00:00+00:00,0,997,997,44,-9.494
2017-01-27 22:00:00+00:00,0,1018,1018,39,-10.336
2017-01-27 23:00:00+00:00,0,1016,1016,39,-10.913
2017-01-28 00:00:00+00:00,0,1021,1021,37,-11.432
2017-01-28 01:00:00+00:00,0,999,999,36,-11.265
2017-01-28 02:00:00+00:00,0,1063,1063,37,-11.033
2017-01-28 03:00:00+00:00,0,1076,1076,37,-10.708
2017-01-28 04:00:00+00:00,0,918,918,36,-10.201
2017-01-28 05:00:00+00:00,0,767,767,35,-9.818
2017-01-28 06:00:00+00:00,8,614,622,37,-9.414
2017-01-28 07:00:00+00:00,15,560,575,42,-8.331
2017-01-28 08:00:00+00:00,40,469,509,43,-5.699
2017-01-28 09:00:00+00:00,83,389,472,43,-2.138
2017-01-28 10:00:00+00:00,126,334,460,42,-0.773
2017-01-28 11:00:00+00:00,150,280,430,40,-0.003
2017-01-28 12:00:00+00:00,145,222,367,39,0.354
2017-01-28 13:00:00+00:00,113,184,297,40,0.495
2017-01-28 14:00:00+00:00,67,167,234,42,0.288
2017-01-28 15:00:00+00:00,26,140,166,49,-0.63
2017-01-28 16:00:00+00:00,9,126,135,56,-2.179
2017-01-28 17:00:00+00:00,8,120,128,55,-3.353
2017-01-28 18:00:00+00:00,0,106,106,49,-4.35
2017-01-28 19:00:00+00:00,0,108,108,40,-5.216
2017-01-28 20:00:00+00:00,0,94,94,36,-6.007
2017-01-28 21:00:00+00:00,0,65,65,36,-6.69
2017-01-28 22:00:00+00:00,0,45,45,33,-7.272
2017-01-28 23:00:00+00:00,0,34,34,33,-7.7
2017-01-29 00:00:00+00:00,0,18,18,31,-8.018
2017-01-29 01:00:00+00:00,0,10,10,29,-8.276
2017-01-29 02:00:00+00:00,0,7,7,28,-8.477
2017-01-29 03:00:00+00:00,0,5,5,29,-8.451
2017-01-29 04:00:00+00:00,0,4,4,28,-8.187
2017-01-29 05:00:00+00:00,0,3,3,24,-7.902
2017-01-29 06:00:00+00:00,8,3,11,26,-7.603
2017-01-29 07:00:00+00:00,15,3,18,26,-6.61
2017-01-29 08:00:00+00:00,41,4,45,31,-4.388
2017-01-29 09:00:00+00:00,83,1,84,32,-1.96
2017-01-29 10:00:00+00:00,126,2,128,33,-0.809
2017-01-29 11:00:00+00:00,148,1,149,32,0.074
2017-01-29 12:00:00+00:00,142,2,144,29,0.733
2017-01-29 13:00:00+00:00,110,4,114,29,0.733
2017-01-29 14:00:00+00:00,66,5,71,32,0.265
2017-01-29 15:00:00+00:00,26,6,32,36,-0.772
2017-01-29 16:00:00+00:00,10,6,16,42,-2.156
2017-01-29 17:00:00+00:00,8,4,12,43,-3.177
2017-01-29 18:00:00+00:00,0,4,4,43,-3.912
2017-01-29 19:00:00+00:00,0,5,5,39,-4.433
2017-01-29 20:00:00+00:00,0,4,4,35,-5.12
2017-01-29 21:00:00+00:00,0,4,4,36,-6.083
2017-01-29 22:00:00+00:00,0,5,5,31,-7.182
2017-01-29 23:00:00+00:00,0,6,6,30,-8.17
2017-01-30 00:00:00+00:00,0,5,5,30,-8.965
2017-01-30 01:00:00+00:00,0,3,3,28,-9.498
2017-01-30 02:00:00+00:00,0,4,4,28,-9.748
2017-01-30 03:00:00+00:00,0,5,5,30,-9.645
2017-01-30 04:00:00+00:00,0,6,6,32,-9.279
2017-01-30 05:00:00+00:00,0,7,7,40,-8.847
2017-01-30 06:00:00+00:00,8,11,19,55,-8.432
2017-01-30 07:00:00+00:00,16,12,28,52,-7.231
2017-01-30 08:00:00+00:00,41,16,57,52,-4.759
2017-01-30 09:00:00+00:00,83,19,102,51,-1.705
2017-01-30 10:00:00+00:00,126,24,150,54,-0.551
2017-01-30 11:00:00+00:00,153,37,190,53,0.3
2017-01-30 12:00:00+00:00,149,52,201,54,0.729
2017-01-30 13:00:00+00:00,117,80,197,55,0.791
2017-01-30 14:00:00+00:00,71,98,169,59,0.508
2017-01-30 15:00:00+00:00,28,124,152,60,-0.557
2017-01-30 16:00:00+00:00,10,142,152,68,-1.735
2017-01-30 17:00:00+00:00,8,179,187,68,-2.733
2017-01-30 18:00:00+00:00,0,197,197,62,-3.362
2017-01-30 19:00:00+00:00,0,201,201,54,-3.574
2017-01-30 20:00:00+00:00,0,182,182,46,-3.555
2017-01-30 21:00:00+00:00,0,167,167,45,-3.516
2017-01-30 22:00:00+00:00,0,131,131,39,-3.612
2017-01-30 23:00:00+00:00,0,87,87,36,-3.813
2017-01-31 00:00:00+00:00,0,73,73,35,-3.914
2017-01-31 01:00:00+00:00,0,53,53,36,-3.888
2017-01-31 02:00:00+00:00,0,77,77,35,-3.698
2017-01-31 03:00:00+00:00,0,88,88,34,-3.6
2017-01-31 04:00:00+00:00,0,60,60,36,-3.638
2017-01-31 05:00:00+00:00,0,52,52,38,-3.83
2017-01-31 06:00:00+00:00,8,56,64,65,-4.188
2017-01-31 07:00:00+00:00,17,51,68,79,-3.756
2017-01-31 08:00:00+00:00,44,69,113,82,-1.853
2017-01-31 09:00:00+00:00,82,66,148,83,-0.735
2017-01-31 10:00:00+00:00,117,76,193,85,0.015
2017-01-31 11:00:00+00:00,131,78,209,81,0.302
2017-01-31 12:00:00+00:00,123,93,216,79,0.184
2017-01-31 13:00:00+00:00,96,120,216,76,-0.013
2017-01-31 14:00:00+00:00,56,114,170,75,-0.283
2017-01-31 15:00:00+00:00,23,106,129,76,-0.665
2017-01-31 16:00:00+00:00,10,124,134,91,-1.002
2017-01-31 17:00:00+00:00,8,94,102,92,-1.104
2017-01-31 18:00:00+00:00,0,74,74,88,-1.245
2017-01-31 19:00:00+00:00,0,76,76,61,-1.435
2017-01-31 20:00:00+00:00,0,79,79,52,-1.574
2017-01-31 21:00:00+00:00,0,68,68,48,-1.789
2017-01-31 22:00:00+00:00,0,82,82,40,-1.779
2017-01-31 23:00:00+00:00,0,60,60,44,-2.014
2017-02-01 00:00:00+00:00,0,57,57,41,-2.658
2017-02-01 01:00:00+00:00,0,26,26,40,-3.457
2017-02-01 02:00:00+00:00,0,17,17,39,-4.059
2017-02-01 03:00:00+00:00,0,17,17,40,-4.375
2017-02-01 04:00:00+00:00,0,14,14,42,-4.486
2017-02-01 05:00:00+00:00,0,4,4,51,-4.596
2017-02-01 06:00:00+00:00,8,8,16,67,-4.669
2017-02-01 07:00:00+00:00,17,12,29,68,-3.963
2017-02-01 08:00:00+00:00,41,7,48,66,-1.997
2017-02-01 09:00:00+00:00,75,7,82,64,-0.248
2017-02-01 10:00:00+00:00,102,8,110,63,0.605
2017-02-01 11:00:00+00:00,121,11,132,57,0.83
2017-02-01 12:00:00+00:00,122,11,133,56,0.831
2017-02-01 13:00:00+00:00,103,17,120,55,0.731
2017-02-01 14:00:00+00:00,69,36,105,54,0.5
2017-02-01 15:00:00+00:00,29,46,75,55,-0.272
2017-02-01 16:00:00+00:00,10,47,57,60,-0.844
2017-02-01 17:00:00+00:00,7,41,48,55,-0.939
2017-02-01 18:00:00+00:00,0,39,39,50,-0.909
2017-02-01 19:00:00+00:00,0,51,51,44,-0.848
2017-02-01 20:00:00+00:00,0,64,64,39,-1.026
2017-02-01 21:00:00+00:00,0,73,73,38,-1.394
2017-02-01 22:00:00+00:00,0,69,69,34,-1.911
2017-02-01 23:00:00+00:00,0,65,65,36,-2.523
2017-02-02 00:00:00+00:00,0,70,70,35,-2.788
2017-02-02 01:00:00+00:00,0,64,64,34,-3.298
2017-02-02 02:00:00+00:00,0,70,70,33,-4.054
2017-02-02 03:00:00+00:00,0,78,78,34,-4.257
2017-02-02 04:00:00+00:00,0,89,89,36,-4.201
2017-02-02 05:00:00+00:00,0,75,75,42,-3.962
2017-02-02 06:00:00+00:00,8,65,73,55,-3.593
2017-02-02 07:00:00+00:00,21,51,72,59,-2.499
2017-02-02 08:00:00+00:00,51,56,107,58,-1.372
2017-02-02 09:00:00+00:00,89,66,155,58,-0.534
2017-02-02 10:00:00+00:00,121,70,191,56,0.107
2017-02-02 11:00:00+00:00,139,73,212,52,0.398
2017-02-02 12:00:00+00:00,139,66,205,48,0.447
2017-02-02 13:00:00+00:00,118,66,184,48,0.387
2017-02-02 14:00:00+00:00,81,80,161,51,0.247
2017-02-02 15:00:00+00:00,37,76,113,54,-0.067
2017-02-02 16:00:00+00:00,12,73,85,59,-0.5
2017-02-02 17:00:00+00:00,7,79,86,57,-1.005
2017-02-02 18:00:00+00:00,0,92,92,49,-1.911
2017-02-02 19:00:00+00:00,0,100,100,43,-2.584
2017-02-02 20:00:00+00:00,0,108,108,40,-2.9
2017-02-02 21:00:00+00:00,0,118,118,40,-2.853
2017-02-02 22:00:00+00:00,0,106,106,36,-2.578
2017-02-02 23:00:00+00:00,0,97,97,33,-2.177
2017-02-03 00:00:00+00:00,0,86,86,33,-1.948
2017-02-03 01:00:00+00:00,0,86,86,32,-1.98
2017-02-03 02:00:00+00:00,0,79,79,31,-2.048
2017-02-03 03:00:00+00:00,0,65,65,32,-2.058
2017-02-03 04:00:00+00:00,0,60,60,34,-2.046
2017-02-03 05:00:00+00:00,0,54,54,43,-2.133
2017-02-03 06:00:00+00:00,8,48,56,57,-2.029
2017-02-03 07:00:00+00:00,26,47,73,58,-0.876
2017-02-03 08:00:00+00:00,65,53,118,59,0.222
2017-02-03 09:00:00+00:00,110,44,154,60,0.646
2017-02-03 10:00:00+00:00,149,40,189,61,0.863
2017-02-03 11:00:00+00:00,170,35,205,60,0.951
2017-02-03 12:00:00+00:00,157,44,201,56,0.947
2017-02-03 13:00:00+00:00,123,44,167,53,0.866
2017-02-03 14:00:00+00:00,81,47,128,54,0.653
2017-02-03 15:00:00+00:00,36,46,82,57,0.349
2017-02-03 16:00:00+00:00,12,46,58,61,-0.179
2017-02-03 17:00:00+00:00,7,35,42,63,-0.885
2017-02-03 18:00:00+00:00,0,35,35,59,-1.787
2017-02-03 19:00:00+00:00,0,34,34,50,-2.428
2017-02-03 20:00:00+00:00,0,39,39,44,-2.78
2017-02-03 21:00:00+00:00,0,78,78,44,-3.084
2017-02-03 22:00:00+00:00,0,141,141,39,-3.139
2017-02-03 23:00:00+00:00,0,246,246,36,-3.122
2017-02-04 00:00:00+00:00,0,315,315,34,-2.914
2017-02-04 01:00:00+00:00,0,239,239,33,-2.615
2017-02-04 02:00:00+00:00,0,222,222,33,-2.595
2017-02-04 03:00:00+00:00,0,301,301,32,-2.688
2017-02-04 04:00:00+00:00,0,384,384,33,-2.781
2017-02-04 05:00:00+00:00,0,530,530,34,-2.628
2017-02-04 06:00:00+00:00,9,423,432,37,-2.155
2017-02-04 07:00:00+00:00,31,222,253,42,-2.179
2017-02-04 08:00:00+00:00,80,131,211,43,-0.509
2017-02-04 09:00:00+00:00,145,55,200,44,0.52
2017-02-04 10:00:00+00:00,214,21,235,45,1.109
2017-02-04 11:00:00+00:00,267,34,301,45,1.452
2017-02-04 12:00:00+00:00,270,66,336,42,1.117
2017-02-04 13:00:00+00:00,220,184,404,43,0.522
2017-02-04 14:00:00+00:00,141,348,489,45,-0.121
2017-02-04 15:00:00+00:00,60,521,581,49,-0.919
2017-02-04 16:00:00+00:00,16,726,742,54,-1.486
2017-02-04 17:00:00+00:00,8,821,829,59,-1.862
2017-02-04 18:00:00+00:00,0,878,878,53,-2.099
2017-02-04 19:00:00+00:00,0,811,811,47,-2.36
2017-02-04 20:00:00+00:00,0,574,574,41,-2.988
2017-02-04 21:00:00+00:00,0,298,298,41,-3.342
2017-02-04 22:00:00+00:00,0,198,198,39,-4.014
2017-02-04 23:00:00+00:00,0,335,335,35,-4.775
2017-02-05 00:00:00+00:00,0,570,570,34,-4.995
2017-02-05 01:00:00+00:00,0,830,830,34,-4.933
2017-02-05 02:00:00+00:00,0,767,767,32,-4.911
2017-02-05 03:00:00+00:00,0,960,960,32,-4.884
2017-02-05 04:00:00+00:00,0,1015,1015,31,-4.683
2017-02-05 05:00:00+00:00,0,1035,1035,32,-4.447
2017-02-05 06:00:00+00:00,11,797,808,34,-4.958
2017-02-05 07:00:00+00:00,49,474,523,36,-4.526
2017-02-05 08:00:00+00:00,125,312,437,37,-2.242
2017-02-05 09:00:00+00:00,217,213,430,41,-0.438
2017-02-05 10:00:00+00:00,293,160,453,43,0.557
2017-02-05 11:00:00+00:00,332,59,391,41,1.014
2017-02-05 12:00:00+00:00,316,72,388,37,0.825
2017-02-05 13:00:00+00:00,251,122,373,37,0.014
2017-02-05 14:00:00+00:00,157,231,388,38,-1.115
2017-02-05 15:00:00+00:00,65,355,420,44,-2.205
2017-02-05 16:00:00+00:00,17,566,583,52,-2.87
2017-02-05 17:00:00+00:00,8,772,780,57,-3.131
2017-02-05 18:00:00+00:00,0,787,787,54,-3.362
2017-02-05 19:00:00+00:00,0,722,722,46,-3.577
2017-02-05 20:00:00+00:00,0,718,718,40,-3.692
2017-02-05 21:00:00+00:00,0,608,608,45,-3.808
2017-02-05 22:00:00+00:00,0,566,566,37,-3.598
2017-02-05 23:00:00+00:00,0,558,558,36,-3.243
2017-02-06 00:00:00+00:00,0,502,502,35,-2.886
2017-02-06 01:00:00+00:00,0,396,396,34,-2.825
2017-02-06 02:00:00+00:00,0,344,344,34,-3.153
2017-02-06 03:00:00+00:00,0,326,326,34,-3.508
2017-02-06 04:00:00+00:00,0,403,403,37,-3.904
2017-02-06 05:00:00+00:00,0,415,415,48,-4.2
2017-02-06 06:00:00+00:00,8,342,350,66,-4.283
2017-02-06 07:00:00+00:00,25,354,379,74,-3.419
2017-02-06 08:00:00+00:00,62,337,399,71,-2.615
2017-02-06 09:00:00+00:00,103,259,362,74,-2.28
2017-02-06 10:00:00+00:00,126,256,382,73,-2.019
2017-02-06 11:00:00+00:00,128,298,426,71,-1.906
2017-02-06 12:00:00+00:00,117,436,553,67,-1.94
2017-02-06 13:00:00+00:00,102,675,777,63,-2.184
2017-02-06 14:00:00+00:00,76,819,895,64,-2.642
2017-02-06 15:00:00+00:00,38,956,994,62,-3.251
2017-02-06 16:00:00+00:00,13,1080,1093,70,-4.097
2017-02-06 17:00:00+00:00,7,1218,1225,72,-4.596
2017-02-06 18:00:00+00:00,0,1266,1266,67,-4.915
2017-02-06 19:00:00+00:00,0,1313,1313,59,-5.139
2017-02-06 20:00:00+00:00,0,1317,1317,52,-5.091
2017-02-06 21:00:00+00:00,0,1348,1348,50,-4.886
2017-02-06 22:00:00+00:00,0,1383,1383,40,-4.716
2017-02-06 23:00:00+00:00,0,1303,1303,43,-4.61
2017-02-07 00:00:00+00:00,0,1260,1260,40,-4.551
2017-02-07 01:00:00+00:00,0,1263,1263,39,-4.555
2017-02-07 02:00:00+00:00,0,1440,1440,39,-4.582
2017-02-07 03:00:00+00:00,0,1500,1500,38,-4.653
2017-02-07 04:00:00+00:00,0,1367,1367,41,-4.817
2017-02-07 05:00:00+00:00,0,1365,1365,52,-5.096
2017-02-07 06:00:00+00:00,9,1368,1377,71,-5.273
2017-02-07 07:00:00+00:00,29,1354,1383,76,-4.414
2017-02-07 08:00:00+00:00,69,1258,1327,75,-3.246
2017-02-07 09:00:00+00:00,114,1358,1472,72,-2.585
2017-02-07 10:00:00+00:00,150,1430,1580,71,-2.005
2017-02-07 11:00:00+00:00,168,1527,1695,67,-1.578
2017-02-07 12:00:00+00:00,170,1512,1682,65,-1.361
2017-02-07 13:00:00+00:00,145,1449,1594,64,-1.405
2017-02-07 14:00:00+00:00,102,1301,1403,61,-1.804
2017-02-07 15:00:00+00:00,51,1153,1204,63,-2.777
2017-02-07 16:00:00+00:00,16,1067,1083,70,-3.858
2017-02-07 17:00:00+00:00,7,1131,1138,71,-4.39
2017-02-07 18:00:00+00:00,0,1068,1068,66,-4.705
2017-02-07 19:00:00+00:00,0,981,981,54,-4.97
2017-02-07 20:00:00+00:00,0,929,929,43,-5.182
2017-02-07 21:00:00+00:00,0,868,868,42,-5.242
2017-02-07 22:00:00+00:00,0,856,856,37,-5.343
2017-02-07 23:00:00+00:00,0,889,889,40,-5.464
2017-02-08 00:00:00+00:00,0,867,867,38,-5.521
2017-02-08 01:00:00+00:00,0,878,878,37,-5.667
2017-02-08 02:00:00+00:00,0,740,740,36,-5.903
2017-02-08 03:00:00+00:00,0,633,633,37,-6.294
2017-02-08 04:00:00+00:00,0,681,681,40,-6.612
2017-02-08 05:00:00+00:00,0,765,765,51,-6.917
2017-02-08 06:00:00+00:00,10,809,819,66,-7.238
2017-02-08 07:00:00+00:00,38,807,845,69,-6.552
2017-02-08 08:00:00+00:00,93,666,759,70,-4.404
2017-02-08 09:00:00+00:00,157,655,812,69,-2.558
2017-02-08 10:00:00+00:00,212,641,853,68,-1.676
2017-02-08 11:00:00+00:00,242,557,799,69,-1.278
2017-02-08 12:00:00+00:00,238,457,695,68,-1.219
2017-02-08 13:00:00+00:00,198,425,623,66,-1.482
2017-02-08 14:00:00+00:00,130,419,549,67,-2.07
2017-02-08 15:00:00+00:00,57,354,411,73,-3.357
2017-02-08 16:00:00+00:00,16,335,351,78,-5.045
2017-02-08 17:00:00+00:00,8,278,286,88,-5.705
2017-02-08 18:00:00+00:00,0,249,249,82,-6.022
2017-02-08 19:00:00+00:00,0,180,180,68,-6.288
2017-02-08 20:00:00+00:00,0,150,150,58,-6.61
2017-02-08 21:00:00+00:00,0,143,143,56,-6.961
2017-02-08 22:00:00+00:00,0,150,150,47,-7.308
2017-02-08 23:00:00+00:00,0,156,156,47,-7.658
2017-02-09 00:00:00+00:00,0,183,183,45,-7.947
2017-02-09 01:00:00+00:00,0,170,170,44,-8.17
2017-02-09 02:00:00+00:00,0,138,138,43,-8.397
2017-02-09 03:00:00+00:00,0,115,115,44,-8.679
2017-02-09 04:00:00+00:00,0,107,107,46,-9.018
2017-02-09 05:00:00+00:00,0,114,114,57,-9.464
2017-02-09 06:00:00+00:00,11,110,121,78,-9.981
2017-02-09 07:00:00+00:00,41,93,134,82,-8.814
2017-02-09 08:00:00+00:00,108,64,172,78,-5.715
2017-02-09 09:00:00+00:00,189,45,234,74,-3.927
2017-02-09 10:00:00+00:00,258,38,296,73,-2.907
2017-02-09 11:00:00+00:00,303,45,348,72,-2.412
2017-02-09 12:00:00+00:00,288,52,340,70,-2.278
2017-02-09 13:00:00+00:00,230,52,282,68,-2.466
2017-02-09 14:00:00+00:00,149,51,200,67,-3.078
2017-02-09 15:00:00+00:00,66,66,132,68,-4.486
2017-02-09 16:00:00+00:00,18,97,115,72,-6.696
2017-02-09 17:00:00+00:00,8,98,106,79,-8.14
2017-02-09 18:00:00+00:00,0,116,116,75,-8.938
2017-02-09 19:00:00+00:00,0,141,141,59,-9.562
2017-02-09 20:00:00+00:00,0,190,190,47,-9.978
2017-02-09 21:00:00+00:00,0,220,220,45,-10.053
2017-02-09 22:00:00+00:00,0,282,282,42,-10.194
2017-02-09 23:00:00+00:00,0,352,352,38,-10.256
2017-02-10 00:00:00+00:00,0,425,425,37,-10.3
2017-02-10 01:00:00+00:00,0,528,528,36,-10.239
2017-02-10 02:00:00+00:00,0,622,622,36,-10.169
2017-02-10 03:00:00+00:00,0,771,771,36,-10.145
2017-02-10 04:00:00+00:00,0,930,930,37,-9.995
2017-02-10 05:00:00+00:00,0,1054,1054,42,-9.745
2017-02-10 06:00:00+00:00,12,1028,1040,60,-9.332
2017-02-10 07:00:00+00:00,47,875,922,58,-7.249
2017-02-10 08:00:00+00:00,112,868,980,58,-4.629
2017-02-10 09:00:00+00:00,192,1021,1213,57,-2.593
2017-02-10 10:00:00+00:00,260,1122,1382,56,-1.23
2017-02-10 11:00:00+00:00,295,1203,1498,52,-0.359
2017-02-10 12:00:00+00:00,281,1271,1552,46,0.138
2017-02-10 13:00:00+00:00,219,1253,1472,44,0.224
2017-02-10 14:00:00+00:00,140,1183,1323,45,-0.231
2017-02-10 15:00:00+00:00,63,1226,1289,48,-1.381
2017-02-10 16:00:00+00:00,18,1361,1379,56,-2.962
2017-02-10 17:00:00+00:00,8,1370,1378,58,-3.887
2017-02-10 18:00:00+00:00,0,1434,1434,52,-4.363
2017-02-10 19:00:00+00:00,0,1461,1461,43,-4.7
2017-02-10 20:00:00+00:00,0,1428,1428,40,-4.925
2017-02-10 21:00:00+00:00,0,1363,1363,41,-4.995
2017-02-10 22:00:00+00:00,0,1358,1358,38,-5.085
2017-02-10 23:00:00+00:00,0,1315,1315,38,-5.209
2017-02-11 00:00:00+00:00,0,1391,1391,35,-5.241
2017-02-11 01:00:00+00:00,0,1458,1458,34,-5.218
2017-02-11 02:00:00+00:00,0,1402,1402,34,-5.335
2017-02-11 03:00:00+00:00,0,1523,1523,36,-5.773
2017-02-11 04:00:00+00:00,0,1538,1538,36,-6.296
2017-02-11 05:00:00+00:00,0,1426,1426,34,-6.678
2017-02-11 06:00:00+00:00,11,1530,1541,38,-6.651
2017-02-11 07:00:00+00:00,44,1524,1568,42,-4.448
2017-02-11 08:00:00+00:00,111,1392,1503,45,-1.919
2017-02-11 09:00:00+00:00,186,1360,1546,45,-0.229
2017-02-11 10:00:00+00:00,256,1321,1577,43,0.956
2017-02-11 11:00:00+00:00,294,1191,1485,39,1.631
2017-02-11 12:00:00+00:00,284,1317,1601,36,1.855
2017-02-11 13:00:00+00:00,227,1370,1597,36,1.644
2017-02-11 14:00:00+00:00,146,1191,1337,37,0.952
2017-02-11 15:00:00+00:00,67,1186,1253,40,-0.509
2017-02-11 16:00:00+00:00,20,1341,1361,47,-2.905
2017-02-11 17:00:00+00:00,8,1356,1364,48,-4.175
2017-02-11 18:00:00+00:00,0,1357,1357,47,-4.793
2017-02-11 19:00:00+00:00,0,1469,1469,38,-5.2
2017-02-11 20:00:00+00:00,0,1407,1407,36,-5.632
2017-02-11 21:00:00+00:00,0,1290,1290,38,-5.949
2017-02-11 22:00:00+00:00,0,1228,1228,34,-6.357
2017-02-11 23:00:00+00:00,0,1158,1158,33,-6.79
2017-02-12 00:00:00+00:00,0,1071,1071,33,-7.185
2017-02-12 01:00:00+00:00,0,1110,1110,31,-7.583
2017-02-12 02:00:00+00:00,0,1069,1069,30,-7.983
2017-02-12 03:00:00+00:00,0,1042,1042,31,-8.281
2017-02-12 04:00:00+00:00,0,927,927,31,-8.293
2017-02-12 05:00:00+00:00,0,952,952,30,-8.091
2017-02-12 06:00:00+00:00,12,942,954,32,-7.747
2017-02-12 07:00:00+00:00,42,841,883,34,-6.107
2017-02-12 08:00:00+00:00,102,677,779,36,-3.436
2017-02-12 09:00:00+00:00,182,614,796,38,-1.211
2017-02-12 10:00:00+00:00,261,647,908,42,0.636
2017-02-12 11:00:00+00:00,305,702,1007,40,1.816
2017-02-12 12:00:00+00:00,293,678,971,34,2.111
2017-02-12 13:00:00+00:00,235,565,800,31,1.988
2017-02-12 14:00:00+00:00,151,507,658,34,1.436
2017-02-12 15:00:00+00:00,69,528,597,39,0.251
2017-02-12 16:00:00+00:00,20,543,563,43,-1.111
2017-02-12 17:00:00+00:00,8,540,548,50,-1.969
2017-02-12 18:00:00+00:00,0,460,460,48,-2.55
2017-02-12 19:00:00+00:00,0,449,449,42,-2.95
2017-02-12 20:00:00+00:00,0,398,398,36,-3.324
2017-02-12 21:00:00+00:00,0,369,369,41,-3.711
2017-02-12 22:00:00+00:00,0,296,296,36,-4.247
2017-02-12 23:00:00+00:00,0,269,269,35,-4.894
2017-02-13 00:00:00+00:00,0,233,233,33,-5.469
2017-02-13 01:00:00+00:00,0,187,187,31,-5.954
2017-02-13 02:00:00+00:00,0,176,176,30,-6.219
2017-02-13 03:00:00+00:00,0,173,173,33,-6.278
2017-02-13 04:00:00+00:00,0,163,163,39,-6.215
2017-02-13 05:00:00+00:00,0,139,139,49,-6.16
2017-02-13 06:00:00+00:00,15,119,134,72,-6.203
2017-02-13 07:00:00+00:00,56,108,164,64,-5.148
2017-02-13 08:00:00+00:00,142,70,212,63,-2.756
2017-02-13 09:00:00+00:00,239,70,309,60,-0.848
2017-02-13 10:00:00+00:00,320,88,408,56,0.5
2017-02-13 11:00:00+00:00,358,116,474,53,1.022
2017-02-13 12:00:00+00:00,344,133,477,48,1.078
2017-02-13 13:00:00+00:00,282,144,426,48,0.707
2017-02-13 14:00:00+00:00,188,164,352,50,-0.131
2017-02-13 15:00:00+00:00,87,239,326,54,-1.736
2017-02-13 16:00:00+00:00,24,316,340,56,-3.54
2017-02-13 17:00:00+00:00,8,367,375,62,-4.505
2017-02-13 18:00:00+00:00,0,370,370,58,-4.937
2017-02-13 19:00:00+00:00,0,398,398,53,-5.248
2017-02-13 20:00:00+00:00,0,405,405,44,-5.667
2017-02-13 21:00:00+00:00,0,407,407,41,-5.922
2017-02-13 22:00:00+00:00,0,453,453,37,-6.088
2017-02-13 23:00:00+00:00,0,468,468,34,-6.374
2017-02-14 00:00:00+00:00,0,498,498,34,-6.65
2017-02-14 01:00:00+00:00,0,529,529,32,-6.883
2017-02-14 02:00:00+00:00,0,547,547,33,-7.042
2017-02-14 03:00:00+00:00,0,589,589,33,-7.368
2017-02-14 04:00:00+00:00,0,563,563,35,-7.661
2017-02-14 05:00:00+00:00,0,528,528,43,-7.639
2017-02-14 06:00:00+00:00,15,567,582,60,-7.226
2017-02-14 07:00:00+00:00,63,512,575,55,-5.016
2017-02-14 08:00:00+00:00,152,361,513,52,-1.504
2017-02-14 09:00:00+00:00,256,290,546,47,0.942
2017-02-14 10:00:00+00:00,346,322,668,45,2.564
2017-02-14 11:00:00+00:00,392,329,721,42,3.335
2017-02-14 12:00:00+00:00,375,233,608,40,3.626
2017-02-14 13:00:00+00:00,303,146,449,43,3.497
2017-02-14 14:00:00+00:00,198,123,321,47,2.767
2017-02-14 15:00:00+00:00,91,118,209,53,1.234
2017-02-14 16:00:00+00:00,25,133,158,62,-0.721
2017-02-14 17:00:00+00:00,8,118,126,65,-1.886
2017-02-14 18:00:00+00:00,0,96,96,61,-2.587
2017-02-14 19:00:00+00:00,0,97,97,56,-2.91
2017-02-14 20:00:00+00:00,0,60,60,46,-2.91
2017-02-14 21:00:00+00:00,0,44,44,48,-2.843
2017-02-14 22:00:00+00:00,0,31,31,41,-2.801
2017-02-14 23:00:00+00:00,0,32,32,38,-2.773
2017-02-15 00:00:00+00:00,0,35,35,36,-2.647
2017-02-15 01:00:00+00:00,0,37,37,37,-2.515
2017-02-15 02:00:00+00:00,0,66,66,36,-2.333
2017-02-15 03:00:00+00:00,0,60,60,37,-2.049
2017-02-15 04:00:00+00:00,0,54,54,39,-1.761
2017-02-15 05:00:00+00:00,0,55,55,50,-1.513
2017-02-15 06:00:00+00:00,17,57,74,64,-1.139
2017-02-15 07:00:00+00:00,73,63,136,61,0.34
2017-02-15 08:00:00+00:00,174,58,232,55,2.561
2017-02-15 09:00:00+00:00,286,24,310,48,4.103
2017-02-15 10:00:00+00:00,380,20,400,42,5.188
2017-02-15 11:00:00+00:00,427,15,442,40,6.115
2017-02-15 12:00:00+00:00,409,9,418,40,6.505
2017-02-15 13:00:00+00:00,332,5,337,41,6.236
2017-02-15 14:00:00+00:00,218,1,219,48,5.727
2017-02-15 15:00:00+00:00,101,0,101,55,4.75
2017-02-15 16:00:00+00:00,28,0,28,61,3.755
2017-02-15 17:00:00+00:00,8,3,11,67,3.115
2017-02-15 18:00:00+00:00,0,14,14,62,2.637
2017-02-15 19:00:00+00:00,0,32,32,55,2.229
2017-02-15 20:00:00+00:00,0,58,58,45,1.802
2017-02-15 21:00:00+00:00,0,109,109,43,1.366
2017-02-15 22:00:00+00:00,0,165,165,38,0.932
2017-02-15 23:00:00+00:00,0,188,188,33,0.514
2017-02-16 00:00:00+00:00,0,194,194,33,0.077
2017-02-16 01:00:00+00:00,0,243,243,32,-0.372
2017-02-16 02:00:00+00:00,0,248,248,32,-0.765
2017-02-16 03:00:00+00:00,0,202,202,32,-1.15
2017-02-16 04:00:00+00:00,0,206,206,34,-1.552
2017-02-16 05:00:00+00:00,0,207,207,39,-1.907
2017-02-16 06:00:00+00:00,17,169,186,52,-1.896
2017-02-16 07:00:00+00:00,73,124,197,51,-0.523
2017-02-16 08:00:00+00:00,175,112,287,47,1.734
2017-02-16 09:00:00+00:00,282,68,350,42,3.385
2017-02-16 10:00:00+00:00,369,51,420,37,4.928
2017-02-16 11:00:00+00:00,412,53,465,36,5.487
2017-02-16 12:00:00+00:00,392,58,450,35,5.554
2017-02-16 13:00:00+00:00,317,62,379,36,5.28
2017-02-16 14:00:00+00:00,210,66,276,41,4.311
2017-02-16 15:00:00+00:00,99,68,167,49,3.063
2017-02-16 16:00:00+00:00,28,69,97,54,2.193
2017-02-16 17:00:00+00:00,8,47,55,58,1.744
2017-02-16 18:00:00+00:00,0,31,31,53,1.274
2017-02-16 19:00:00+00:00,0,21,21,46,0.76
2017-02-16 20:00:00+00:00,0,22,22,37,0.16
2017-02-16 21:00:00+00:00,0,21,21,36,-0.38
2017-02-16 22:00:00+00:00,0,22,22,32,-0.885
2017-02-16 23:00:00+00:00,0,21,21,31,-1.42
2017-02-17 00:00:00+00:00,0,23,23,30,-1.943
2017-02-17 01:00:00+00:00,0,28,28,30,-2.424
2017-02-17 02:00:00+00:00,0,46,46,29,-2.793
2017-02-17 03:00:00+00:00,0,74,74,29,-3.039
2017-02-17 04:00:00+00:00,0,72,72,31,-2.924
2017-02-17 05:00:00+00:00,0,69,69,34,-2.714
2017-02-17 06:00:00+00:00,14,63,77,46,-2.387
2017-02-17 07:00:00+00:00,50,42,92,50,-1.343
2017-02-17 08:00:00+00:00,108,26,134,51,-0.224
2017-02-17 09:00:00+00:00,165,37,202,48,0.729
2017-02-17 10:00:00+00:00,203,49,252,46,0.997
2017-02-17 11:00:00+00:00,219,56,275,42,0.842
2017-02-17 12:00:00+00:00,201,94,295,41,0.32
2017-02-17 13:00:00+00:00,166,147,313,41,-0.449
2017-02-17 14:00:00+00:00,119,222,341,44,-1.172
2017-02-17 15:00:00+00:00,61,286,347,48,-1.921
2017-02-17 16:00:00+00:00,19,353,372,52,-2.876
2017-02-17 17:00:00+00:00,8,496,504,57,-3.602
2017-02-17 18:00:00+00:00,0,700,700,51,-4.232
2017-02-17 19:00:00+00:00,0,927,927,48,-4.819
2017-02-17 20:00:00+00:00,0,1041,1041,43,-5.123
2017-02-17 21:00:00+00:00,0,1058,1058,42,-5.347
2017-02-17 22:00:00+00:00,0,898,898,38,-5.378
2017-02-17 23:00:00+00:00,0,768,768,40,-5.462
2017-02-18 00:00:00+00:00,0,638,638,37,-5.651
2017-02-18 01:00:00+00:00,0,530,530,36,-5.706
2017-02-18 02:00:00+00:00,0,481,481,36,-5.69
2017-02-18 03:00:00+00:00,0,632,632,36,-5.627
2017-02-18 04:00:00+00:00,0,744,744,37,-5.652
2017-02-18 05:00:00+00:00,0,744,744,36,-5.749
2017-02-18 06:00:00+00:00,17,784,801,42,-5.236
2017-02-18 07:00:00+00:00,61,885,946,46,-3.226
2017-02-18 08:00:00+00:00,130,744,874,51,-1.894
2017-02-18 09:00:00+00:00,198,686,884,50,-0.971
2017-02-18 10:00:00+00:00,258,828,1086,46,-0.329
2017-02-18 11:00:00+00:00,287,805,1092,44,0.027
2017-02-18 12:00:00+00:00,283,684,967,41,0.109
2017-02-18 13:00:00+00:00,235,579,814,39,-0.088
2017-02-18 14:00:00+00:00,162,568,730,39,-0.62
2017-02-18 15:00:00+00:00,85,525,610,41,-1.789
2017-02-18 16:00:00+00:00,27,420,447,48,-3.489
2017-02-18 17:00:00+00:00,9,395,404,54,-3.871
2017-02-18 18:00:00+00:00,0,369,369,52,-4.042
2017-02-18 19:00:00+00:00,0,316,316,44,-4.271
2017-02-18 20:00:00+00:00,0,292,292,39,-4.611
2017-02-18 21:00:00+00:00,0,258,258,37,-5.203
2017-02-18 22:00:00+00:00,0,263,263,33,-5.926
2017-02-18 23:00:00+00:00,0,220,220,32,-6.531
2017-02-19 00:00:00+00:00,0,199,199,32,-7.085
2017-02-19 01:00:00+00:00,0,152,152,31,-7.581
2017-02-19 02:00:00+00:00,0,124,124,30,-7.97
2017-02-19 03:00:00+00:00,0,61,61,30,-8.478
2017-02-19 04:00:00+00:00,0,41,41,28,-9.015
2017-02-19 05:00:00+00:00,0,20,20,27,-9.542
2017-02-19 06:00:00+00:00,19,11,30,27,-9.325
2017-02-19 07:00:00+00:00,76,12,88,30,-6.442
2017-02-19 08:00:00+00:00,169,13,182,31,-3.391
2017-02-19 09:00:00+00:00,279,8,287,31,-0.529
2017-02-19 10:00:00+00:00,374,4,378,33,1.111
2017-02-19 11:00:00+00:00,422,6,428,29,1.837
2017-02-19 12:00:00+00:00,407,10,417,27,2.067
2017-02-19 13:00:00+00:00,336,23,359,25,1.87
2017-02-19 14:00:00+00:00,225,34,259,30,1.162
2017-02-19 15:00:00+00:00,108,97,205,33,-0.418
2017-02-19 16:00:00+00:00,31,192,223,40,-2.014
2017-02-19 17:00:00+00:00,9,335,344,45,-2.672
2017-02-19 18:00:00+00:00,0,409,409,43,-3.19
2017-02-19 19:00:00+00:00,0,407,407,40,-3.574
2017-02-19 20:00:00+00:00,0,301,301,32,-4.097
2017-02-19 21:00:00+00:00,0,271,271,34,-4.404
2017-02-19 22:00:00+00:00,0,255,255,29,-4.39
2017-02-19 23:00:00+00:00,0,260,260,27,-4.39
2017-02-20 00:00:00+00:00,0,287,287,22,-4.422
2017-02-20 01:00:00+00:00,0,337,337,18,-4.352
2017-02-20 02:00:00+00:00,0,321,321,17,-4.305
2017-02-20 03:00:00+00:00,0,334,334,18,-4.4
2017-02-20 04:00:00+00:00,0,335,335,25,-4.671
2017-02-20 05:00:00+00:00,0,320,320,35,-5.035
2017-02-20 06:00:00+00:00,18,319,337,45,-4.725
2017-02-20 07:00:00+00:00,64,240,304,44,-2.549
2017-02-20 08:00:00+00:00,143,232,375,41,-0.899
2017-02-20 09:00:00+00:00,233,251,484,39,0.094
2017-02-20 10:00:00+00:00,305,259,564,36,0.849
2017-02-20 11:00:00+00:00,347,319,666,34,1.525
2017-02-20 12:00:00+00:00,342,279,621,31,1.868
2017-02-20 13:00:00+00:00,285,465,750,35,1.876
2017-02-20 14:00:00+00:00,194,666,860,38,1.433
2017-02-20 15:00:00+00:00,95,710,805,38,0.015
2017-02-20 16:00:00+00:00,28,670,698,40,-1.632
2017-02-20 17:00:00+00:00,9,560,569,42,-2.401
2017-02-20 18:00:00+00:00,0,838,838,41,-3.078
2017-02-20 19:00:00+00:00,0,1089,1089,37,-3.715
2017-02-20 20:00:00+00:00,0,1006,1006,34,-4.157
2017-02-20 21:00:00+00:00,0,1118,1118,30,-4.225
2017-02-20 22:00:00+00:00,0,1240,1240,19,-4.233
2017-02-20 23:00:00+00:00,0,1290,1290,4,-4.144
2017-02-21 00:00:00+00:00,0,1148,1148,6,-4.365
2017-02-21 01:00:00+00:00,0,1102,1102,9,-4.42
2017-02-21 02:00:00+00:00,0,1307,1307,9,-3.951
2017-02-21 03:00:00+00:00,0,1553,1553,11,-3.4
2017-02-21 04:00:00+00:00,0,1517,1517,20,-3.17
2017-02-21 05:00:00+00:00,0,1371,1371,32,-2.864
2017-02-21 06:00:00+00:00,18,1334,1352,42,-1.797
2017-02-21 07:00:00+00:00,61,1384,1445,42,0.376
2017-02-21 08:00:00+00:00,125,1450,1575,40,1.733
2017-02-21 09:00:00+00:00,186,1513,1699,39,2.223
2017-02-21 10:00:00+00:00,228,1563,1791,38,2.463
2017-02-21 11:00:00+00:00,239,1478,1717,37,3.145
2017-02-21 12:00:00+00:00,219,1303,1522,35,3.376
2017-02-21 13:00:00+00:00,175,1348,1523,36,3.038
2017-02-21 14:00:00+00:00,123,1584,1707,38,2.307
2017-02-21 15:00:00+00:00,69,2013,2082,43,1.294
2017-02-21 16:00:00+00:00,23,2024,2047,47,0.219
2017-02-21 17:00:00+00:00,8,1266,1274,52,-0.155
2017-02-21 18:00:00+00:00,0,1043,1043,51,-0.344
2017-02-21 19:00:00+00:00,0,1213,1213,44,-0.475
2017-02-21 20:00:00+00:00,0,1378,1378,38,-0.667
2017-02-21 21:00:00+00:00,0,1234,1234,33,-0.859
2017-02-21 22:00:00+00:00,0,862,862,28,-1.017
2017-02-21 23:00:00+00:00,0,595,595,25,-1.156
2017-02-22 00:00:00+00:00,0,460,460,15,-1.227
2017-02-22 01:00:00+00:00,0,333,333,9,-1.002
2017-02-22 02:00:00+00:00,0,371,371,6,-0.746
2017-02-22 03:00:00+00:00,0,488,488,5,-0.487
2017-02-22 04:00:00+00:00,0,728,728,5,-0.353
2017-02-22 05:00:00+00:00,0,938,938,18,-0.263
2017-02-22 06:00:00+00:00,20,998,1018,29,0.088
2017-02-22 07:00:00+00:00,69,1158,1227,33,1.381
2017-02-22 08:00:00+00:00,147,1193,1340,33,3.133
2017-02-22 09:00:00+00:00,233,1016,1249,31,4.243
2017-02-22 10:00:00+00:00,322,1035,1357,31,5.228
2017-02-22 11:00:00+00:00,381,1025,1406,29,5.859
2017-02-22 12:00:00+00:00,359,947,1306,26,6.046
2017-02-22 13:00:00+00:00,277,1107,1384,26,5.722
2017-02-22 14:00:00+00:00,183,1201,1384,26,4.833
2017-02-22 15:00:00+00:00,91,1417,1508,29,2.362
2017-02-22 16:00:00+00:00,28,1532,1560,33,-0.001
2017-02-22 17:00:00+00:00,9,1259,1268,36,-0.937
2017-02-22 18:00:00+00:00,0,1071,1071,32,-1.335
2017-02-22 19:00:00+00:00,0,1189,1189,31,-1.65
2017-02-22 20:00:00+00:00,0,1567,1567,23,-1.831
2017-02-22 21:00:00+00:00,0,1766,1766,14,-1.913
2017-02-22 22:00:00+00:00,0,1827,1827,11,-1.894
2017-02-22 23:00:00+00:00,0,1696,1696,8,-1.802
2017-02-23 00:00:00+00:00,0,1683,1683,4,-1.477
2017-02-23 01:00:00+00:00,0,1727,1727,4,-1.387
2017-02-23 02:00:00+00:00,0,1757,1757,6,-1.344
2017-02-23 03:00:00+00:00,0,1598,1598,10,-1.604
2017-02-23 04:00:00+00:00,0,1495,1495,23,-1.649
2017-02-23 05:00:00+00:00,0,1485,1485,36,-1.582
2017-02-23 06:00:00+00:00,28,1270,1298,54,-0.614
2017-02-23 07:00:00+00:00,96,1026,1122,54,2.313
2017-02-23 08:00:00+00:00,197,966,1163,48,5.158
2017-02-23 09:00:00+00:00,301,782,1083,46,6.809
2017-02-23 10:00:00+00:00,390,648,1038,45,7.919
2017-02-23 11:00:00+00:00,438,497,935,41,8.384
2017-02-23 12:00:00+00:00,419,478,897,35,8.398
2017-02-23 13:00:00+00:00,341,529,870,32,7.767
2017-02-23 14:00:00+00:00,234,959,1193,30,6.108
2017-02-23 15:00:00+00:00,120,1384,1504,29,3.53
2017-02-23 16:00:00+00:00,38,1647,1685,31,0.564
2017-02-23 17:00:00+00:00,10,1736,1746,36,0.325
2017-02-23 18:00:00+00:00,0,1759,1759,33,0.293
2017-02-23 19:00:00+00:00,0,1618,1618,24,-0.301
2017-02-23 20:00:00+00:00,0,1410,1410,16,-0.984
2017-02-23 21:00:00+00:00,0,1118,1118,10,-1.324
2017-02-23 22:00:00+00:00,0,1043,1043,1,-1.547
2017-02-23 23:00:00+00:00,0,1328,1328,-4,-1.757
2017-02-24 00:00:00+00:00,0,1628,1628,-4,-1.89
2017-02-24 01:00:00+00:00,0,1663,1663,-7,-1.539
2017-02-24 02:00:00+00:00,0,1357,1357,-10,-1.361
2017-02-24 03:00:00+00:00,0,1075,1075,0,-1.215
2017-02-24 04:00:00+00:00,0,1226,1226,6,-1.142
2017-02-24 05:00:00+00:00,0,2091,2091,22,-1.219
2017-02-24 06:00:00+00:00,28,2472,2500,35,-1.213
2017-02-24 07:00:00+00:00,85,2420,2505,36,-0.677
2017-02-24 08:00:00+00:00,168,2393,2561,35,-0.463
2017-02-24 09:00:00+00:00,238,2343,2581,34,-0.423
2017-02-24 10:00:00+00:00,295,2235,2530,35,-0.393
2017-02-24 11:00:00+00:00,321,2147,2468,34,-0.433
2017-02-24 12:00:00+00:00,296,2124,2420,34,-0.547
2017-02-24 13:00:00+00:00,235,2115,2350,36,-0.861
2017-02-24 14:00:00+00:00,164,1887,2051,38,-1.385
2017-02-24 15:00:00+00:00,90,1508,1598,43,-2.029
2017-02-24 16:00:00+00:00,31,1280,1311,51,-2.846
2017-02-24 17:00:00+00:00,9,1545,1554,60,-3.253
2017-02-24 18:00:00+00:00,0,1908,1908,58,-3.6
2017-02-24 19:00:00+00:00,0,2096,2096,51,-3.957
2017-02-24 20:00:00+00:00,0,2032,2032,44,-4.34
2017-02-24 21:00:00+00:00,0,1722,1722,41,-4.757
2017-02-24 22:00:00+00:00,0,1501,1501,34,-5.055
2017-02-24 23:00:00+00:00,0,1482,1482,32,-5.365
2017-02-25 00:00:00+00:00,0,1550,1550,31,-5.866
2017-02-25 01:00:00+00:00,0,1182,1182,31,-6.305
2017-02-25 02:00:00+00:00,0,818,818,28,-6.6
2017-02-25 03:00:00+00:00,0,709,709,29,-6.981
2017-02-25 04:00:00+00:00,0,720,720,31,-7.392
2017-02-25 05:00:00+00:00,0,666,666,34,-7.577
2017-02-25 06:00:00+00:00,31,710,741,38,-6.327
2017-02-25 07:00:00+00:00,109,601,710,40,-4.068
2017-02-25 08:00:00+00:00,228,575,803,39,-2.483
2017-02-25 09:00:00+00:00,357,772,1129,37,-1.214
2017-02-25 10:00:00+00:00,459,793,1252,34,-0.202
2017-02-25 11:00:00+00:00,506,652,1158,29,0.556
2017-02-25 12:00:00+00:00,480,544,1024,25,1.08
2017-02-25 13:00:00+00:00,392,307,699,24,1.278
2017-02-25 14:00:00+00:00,267,119,386,27,0.932
2017-02-25 15:00:00+00:00,135,38,173,32,-0.145
2017-02-25 16:00:00+00:00,42,26,68,37,-1.855
2017-02-25 17:00:00+00:00,11,109,120,39,-3.023
2017-02-25 18:00:00+00:00,0,331,331,36,-4.108
2017-02-25 19:00:00+00:00,0,547,547,30,-4.995
2017-02-25 20:00:00+00:00,0,655,655,24,-5.62
2017-02-25 21:00:00+00:00,0,844,844,21,-5.913
2017-02-25 22:00:00+00:00,0,1084,1084,16,-6.102
2017-02-25 23:00:00+00:00,0,1132,1132,7,-6.2
2017-02-26 00:00:00+00:00,0,1357,1357,5,-6.183
2017-02-26 01:00:00+00:00,0,1532,1532,5,-6.09
2017-02-26 02:00:00+00:00,0,1633,1633,5,-5.907
2017-02-26 03:00:00+00:00,0,1684,1684,3,-5.5
2017-02-26 04:00:00+00:00,0,1762,1762,5,-4.847
2017-02-26 05:00:00+00:00,0,1596,1596,2,-4.209
2017-02-26 06:00:00+00:00,24,1418,1442,8,-2.952
2017-02-26 07:00:00+00:00,78,1221,1299,10,-0.487
2017-02-26 08:00:00+00:00,158,1045,1203,15,1.452
2017-02-26 09:00:00+00:00,235,853,1088,19,3.021
2017-02-26 10:00:00+00:00,299,688,987,25,4.664
2017-02-26 11:00:00+00:00,329,375,704,19,5.291
2017-02-26 12:00:00+00:00,317,223,540,18,5.28
2017-02-26 13:00:00+00:00,266,152,418,18,4.885
2017-02-26 14:00:00+00:00,186,130,316,18,4.186
2017-02-26 15:00:00+00:00,98,181,279,24,3.372
2017-02-26 16:00:00+00:00,32,298,330,32,2.643
2017-02-26 17:00:00+00:00,9,462,471,39,2.19
2017-02-26 18:00:00+00:00,0,404,404,39,1.91
2017-02-26 19:00:00+00:00,0,284,284,34,1.805
2017-02-26 20:00:00+00:00,0,262,262,29,1.734
2017-02-26 21:00:00+00:00,0,263,263,29,1.556
2017-02-26 22:00:00+00:00,0,218,218,24,1.283
2017-02-26 23:00:00+00:00,0,182,182,23,1.031
2017-02-27 00:00:00+00:00,0,185,185,18,0.727
2017-02-27 01:00:00+00:00,0,163,163,17,0.334
2017-02-27 02:00:00+00:00,0,205,205,18,-0.046
2017-02-27 03:00:00+00:00,0,236,236,19,-0.353
2017-02-27 04:00:00+00:00,0,254,254,26,-0.713
2017-02-27 05:00:00+00:00,1,321,322,37,-1.025
2017-02-27 06:00:00+00:00,28,399,427,46,-0.832
2017-02-27 07:00:00+00:00,91,352,443,44,0.432
2017-02-27 08:00:00+00:00,194,303,497,42,1.519
2017-02-27 09:00:00+00:00,316,370,686,38,2.5
2017-02-27 10:00:00+00:00,416,622,1038,37,3.968
2017-02-27 11:00:00+00:00,472,976,1448,32,5.08
2017-02-27 12:00:00+00:00,461,1335,1796,31,5.438
2017-02-27 13:00:00+00:00,397,1714,2111,31,5.128
2017-02-27 14:00:00+00:00,287,2138,2425,33,3.878
2017-02-27 15:00:00+00:00,149,2232,2381,35,1.921
2017-02-27 16:00:00+00:00,47,2199,2246,40,-0.963
2017-02-27 17:00:00+00:00,12,2179,2191,42,-2.182
2017-02-27 18:00:00+00:00,0,2183,2183,38,-2.356
2017-02-27 19:00:00+00:00,0,2136,2136,36,-2.456
2017-02-27 20:00:00+00:00,0,2065,2065,31,-2.443
2017-02-27 21:00:00+00:00,0,1833,1833,25,-2.678
2017-02-27 22:00:00+00:00,0,1697,1697,16,-3.136
2017-02-27 23:00:00+00:00,0,1472,1472,4,-3.455
2017-02-28 00:00:00+00:00,0,1379,1379,1,-3.581
2017-02-28 01:00:00+00:00,0,1377,1377,1,-3.544
2017-02-28 02:00:00+00:00,0,1494,1494,1,-3.283
2017-02-28 03:00:00+00:00,0,1537,1537,4,-2.932
2017-02-28 04:00:00+00:00,0,1779,1779,12,-2.848
2017-02-28 05:00:00+00:00,0,1891,1891,29,-2.717
2017-02-28 06:00:00+00:00,39,1683,1722,36,-1.865
2017-02-28 07:00:00+00:00,120,1520,1640,33,-0.43
2017-02-28 08:00:00+00:00,238,1356,1594,32,1.129
2017-02-28 09:00:00+00:00,371,1238,1609,29,2.233
2017-02-28 10:00:00+00:00,473,1310,1783,30,2.946
2017-02-28 11:00:00+00:00,504,801,1305,29,3.424
2017-02-28 12:00:00+00:00,466,471,937,32,3.612
2017-02-28 13:00:00+00:00,366,211,577,35,3.357
2017-02-28 14:00:00+00:00,241,158,399,38,2.703
2017-02-28 15:00:00+00:00,125,271,396,40,1.836
2017-02-28 16:00:00+00:00,41,794,835,43,0.962
2017-02-28 17:00:00+00:00,11,1528,1539,49,0.53
2017-02-28 18:00:00+00:00,0,2169,2169,48,0.842
2017-02-28 19:00:00+00:00,0,2395,2395,42,0.349
2017-02-28 20:00:00+00:00,0,2353,2353,36,-0.116
2017-02-28 21:00:00+00:00,0,2187,2187,32,-0.701
2017-02-28 22:00:00+00:00,0,2191,2191,27,-1.505
2017-02-28 23:00:00+00:00,0,1656,1656,28,-2.159
2017-03-01 00:00:00+00:00,0,1251,1251,25,-2.708
2017-03-01 01:00:00+00:00,0,1658,1658,24,-3.306
2017-03-01 02:00:00+00:00,0,1128,1128,23,-3.701
2017-03-01 03:00:00+00:00,0,1259,1259,26,-4.028
2017-03-01 04:00:00+00:00,0,1695,1695,31,-4.445
2017-03-01 05:00:00+00:00,0,1814,1814,40,-4.972
2017-03-01 06:00:00+00:00,28,1851,1879,48,-5.069
2017-03-01 07:00:00+00:00,86,1771,1857,45,-4.3
2017-03-01 08:00:00+00:00,180,1487,1667,42,-3.028
2017-03-01 09:00:00+00:00,279,1528,1807,39,-1.655
2017-03-01 10:00:00+00:00,357,1562,1919,36,-0.609
2017-03-01 11:00:00+00:00,392,1662,2054,34,-0.068
2017-03-01 12:00:00+00:00,371,1836,2207,32,0.234
2017-03-01 13:00:00+00:00,309,2212,2521,32,0.385
2017-03-01 14:00:00+00:00,224,2063,2287,33,0.264
2017-03-01 15:00:00+00:00,125,1391,1516,35,-0.68
2017-03-01 16:00:00+00:00,44,894,938,39,-2.396
2017-03-01 17:00:00+00:00,12,703,715,48,-2.809
2017-03-01 18:00:00+00:00,0,490,490,48,-2.885
2017-03-01 19:00:00+00:00,0,416,416,43,-3.333
2017-03-01 20:00:00+00:00,0,401,401,39,-3.814
2017-03-01 21:00:00+00:00,0,523,523,35,-4.312
2017-03-01 22:00:00+00:00,0,483,483,30,-4.749
2017-03-01 23:00:00+00:00,0,518,518,32,-4.965
2017-03-02 00:00:00+00:00,0,623,623,30,-5.103
2017-03-02 01:00:00+00:00,0,833,833,27,-5.133
2017-03-02 02:00:00+00:00,0,1091,1091,24,-4.948
2017-03-02 03:00:00+00:00,0,1073,1073,25,-4.61
2017-03-02 04:00:00+00:00,0,868,868,28,-4.36
2017-03-02 05:00:00+00:00,0,601,601,32,-4.059
2017-03-02 06:00:00+00:00,28,479,507,38,-2.778
2017-03-02 07:00:00+00:00,89,412,501,36,-0.328
2017-03-02 08:00:00+00:00,179,469,648,33,1.301
2017-03-02 09:00:00+00:00,261,565,826,23,2.222
2017-03-02 10:00:00+00:00,312,647,959,20,2.637
2017-03-02 11:00:00+00:00,335,866,1201,16,2.948
2017-03-02 12:00:00+00:00,324,1265,1589,16,3.041
2017-03-02 13:00:00+00:00,281,2012,2293,15,2.868
2017-03-02 14:00:00+00:00,211,2153,2364,19,2.442
2017-03-02 15:00:00+00:00,120,2253,2373,27,1.39
2017-03-02 16:00:00+00:00,43,1969,2012,35,-1.799
2017-03-02 17:00:00+00:00,11,1732,1743,39,-3.549
2017-03-02 18:00:00+00:00,0,1561,1561,40,-4.004
2017-03-02 19:00:00+00:00,0,1664,1664,36,-4.273
2017-03-02 20:00:00+00:00,0,1491,1491,32,-4.529
2017-03-02 21:00:00+00:00,0,1420,1420,29,-4.834
2017-03-02 22:00:00+00:00,0,1344,1344,23,-4.983
2017-03-02 23:00:00+00:00,0,1564,1564,24,-5.03
2017-03-03 00:00:00+00:00,0,1653,1653,23,-4.758
2017-03-03 01:00:00+00:00,0,1584,1584,24,-4.511
2017-03-03 02:00:00+00:00,0,1453,1453,28,-4.545
2017-03-03 03:00:00+00:00,0,1181,1181,29,-5.27
2017-03-03 04:00:00+00:00,0,979,979,33,-6.059
2017-03-03 05:00:00+00:00,0,747,747,41,-6.254
2017-03-03 06:00:00+00:00,34,447,481,49,-4.759
2017-03-03 07:00:00+00:00,107,244,351,48,-2.148
2017-03-03 08:00:00+00:00,207,128,335,45,0.004
2017-03-03 09:00:00+00:00,298,274,572,43,1.509
2017-03-03 10:00:00+00:00,362,917,1279,42,2.714
2017-03-03 11:00:00+00:00,391,1493,1884,39,3.429
2017-03-03 12:00:00+00:00,376,1677,2053,38,3.85
2017-03-03 13:00:00+00:00,317,1960,2277,37,3.88
2017-03-03 14:00:00+00:00,225,2123,2348,40,3.335
2017-03-03 15:00:00+00:00,123,2119,2242,42,1.792
2017-03-03 16:00:00+00:00,43,2122,2165,44,-0.459
2017-03-03 17:00:00+00:00,12,2281,2293,48,-1.025
2017-03-03 18:00:00+00:00,0,2322,2322,48,-0.809
2017-03-03 19:00:00+00:00,0,2313,2313,42,-0.078
2017-03-03 20:00:00+00:00,0,2328,2328,37,0.117
2017-03-03 21:00:00+00:00,0,2352,2352,36,0.068
2017-03-03 22:00:00+00:00,0,2298,2298,33,0.031
2017-03-03 23:00:00+00:00,0,2255,2255,30,0.083
2017-03-04 00:00:00+00:00,0,2284,2284,30,0.206
2017-03-04 01:00:00+00:00,0,2209,2209,28,0.316
2017-03-04 02:00:00+00:00,0,2148,2148,28,0.346
2017-03-04 03:00:00+00:00,0,1960,1960,28,0.36
2017-03-04 04:00:00+00:00,0,1695,1695,28,0.302
2017-03-04 05:00:00+00:00,1,1611,1612,30,0.184
2017-03-04 06:00:00+00:00,39,1613,1652,32,0.74
2017-03-04 07:00:00+00:00,120,1590,1710,35,1.778
2017-03-04 08:00:00+00:00,225,1650,1875,36,2.821
2017-03-04 09:00:00+00:00,326,1803,2129,35,3.562
2017-03-04 10:00:00+00:00,402,1960,2362,33,3.994
2017-03-04 11:00:00+00:00,425,2311,2736,32,4.153
2017-03-04 12:00:00+00:00,400,2515,2915,31,4.077
2017-03-04 13:00:00+00:00,336,2511,2847,32,3.798
2017-03-04 14:00:00+00:00,239,2514,2753,33,3.28
2017-03-04 15:00:00+00:00,127,2522,2649,34,2.597
2017-03-04 16:00:00+00:00,43,2457,2500,39,1.789
2017-03-04 17:00:00+00:00,12,2222,2234,43,1.39
2017-03-04 18:00:00+00:00,0,1815,1815,41,1.543
2017-03-04 19:00:00+00:00,0,1678,1678,36,1.581
2017-03-04 20:00:00+00:00,0,1660,1660,32,0.951
2017-03-04 21:00:00+00:00,0,1705,1705,31,0.021
2017-03-04 22:00:00+00:00,0,1755,1755,26,-1.096
2017-03-04 23:00:00+00:00,0,1838,1838,12,-1.438
2017-03-05 00:00:00+00:00,0,1869,1869,7,-1.385
2017-03-05 01:00:00+00:00,0,2011,2011,6,-0.806
2017-03-05 02:00:00+00:00,0,2269,2269,6,-1.092
2017-03-05 03:00:00+00:00,0,1893,1893,6,-1.258
2017-03-05 04:00:00+00:00,0,1355,1355,5,-1.546
2017-03-05 05:00:00+00:00,1,1034,1035,7,-1.819
2017-03-05 06:00:00+00:00,39,747,786,7,-1.32
2017-03-05 07:00:00+00:00,116,378,494,7,-0.374
2017-03-05 08:00:00+00:00,211,258,469,8,0.599
2017-03-05 09:00:00+00:00,285,171,456,10,1.376
2017-03-05 10:00:00+00:00,323,204,527,10,1.618
2017-03-05 11:00:00+00:00,331,176,507,10,1.736
2017-03-05 12:00:00+00:00,314,310,624,8,1.683
2017-03-05 13:00:00+00:00,269,411,680,9,1.422
2017-03-05 14:00:00+00:00,194,503,697,15,1.051
2017-03-05 15:00:00+00:00,109,571,680,23,0.497
2017-03-05 16:00:00+00:00,41,603,644,32,-1.192
2017-03-05 17:00:00+00:00,12,649,661,37,-2.617
2017-03-05 18:00:00+00:00,0,597,597,38,-2.994
2017-03-05 19:00:00+00:00,0,490,490,34,-3.137
2017-03-05 20:00:00+00:00,0,428,428,31,-3.184
2017-03-05 21:00:00+00:00,0,293,293,32,-3.064
2017-03-05 22:00:00+00:00,0,187,187,25,-2.951
2017-03-05 23:00:00+00:00,0,175,175,26,-2.922
2017-03-06 00:00:00+00:00,0,209,209,23,-3.138
2017-03-06 01:00:00+00:00,0,369,369,22,-3.36
2017-03-06 02:00:00+00:00,0,793,793,29,-3.684
2017-03-06 03:00:00+00:00,0,842,842,30,-3.861
2017-03-06 04:00:00+00:00,0,931,931,33,-4.097
2017-03-06 05:00:00+00:00,0,1397,1397,43,-4.259
2017-03-06 06:00:00+00:00,33,1641,1674,52,-3.346
2017-03-06 07:00:00+00:00,98,1769,1867,51,-1.737
2017-03-06 08:00:00+00:00,183,1955,2138,50,-0.372
2017-03-06 09:00:00+00:00,252,1752,2004,46,0.392
2017-03-06 10:00:00+00:00,295,1268,1563,46,1.078
2017-03-06 11:00:00+00:00,311,783,1094,43,1.723
2017-03-06 12:00:00+00:00,309,693,1002,41,2.157
2017-03-06 13:00:00+00:00,277,379,656,41,2.069
2017-03-06 14:00:00+00:00,210,277,487,43,1.433
2017-03-06 15:00:00+00:00,125,375,500,43,0.485
2017-03-06 16:00:00+00:00,49,579,628,46,-0.978
2017-03-06 17:00:00+00:00,14,689,703,52,-1.708
2017-03-06 18:00:00+00:00,0,783,783,53,-1.937
2017-03-06 19:00:00+00:00,0,746,746,49,-1.928
2017-03-06 20:00:00+00:00,0,651,651,43,-1.883
2017-03-06 21:00:00+00:00,0,514,514,41,-2.509
2017-03-06 22:00:00+00:00,0,396,396,36,-3.567
2017-03-06 23:00:00+00:00,0,315,315,32,-3.926
2017-03-07 00:00:00+00:00,0,298,298,31,-4.012
2017-03-07 01:00:00+00:00,0,184,184,30,-3.777
2017-03-07 02:00:00+00:00,0,157,157,30,-3.673
2017-03-07 03:00:00+00:00,0,209,209,31,-3.513
2017-03-07 04:00:00+00:00,0,442,442,32,-3.463
2017-03-07 05:00:00+00:00,0,547,547,40,-3.464
2017-03-07 06:00:00+00:00,33,527,560,49,-3.146
2017-03-07 07:00:00+00:00,93,478,571,49,-2.512
2017-03-07 08:00:00+00:00,166,550,716,50,-1.766
2017-03-07 09:00:00+00:00,233,710,943,49,-1.133
2017-03-07 10:00:00+00:00,287,999,1286,48,-0.776
2017-03-07 11:00:00+00:00,309,1170,1479,45,-0.512
2017-03-07 12:00:00+00:00,291,1035,1326,44,-0.476
2017-03-07 13:00:00+00:00,253,780,1033,44,-0.737
2017-03-07 14:00:00+00:00,197,670,867,45,-1.179
2017-03-07 15:00:00+00:00,121,866,987,46,-1.929
2017-03-07 16:00:00+00:00,49,1000,1049,52,-3.02
2017-03-07 17:00:00+00:00,14,1198,1212,60,-3.912
2017-03-07 18:00:00+00:00,0,1347,1347,61,-4.114
2017-03-07 19:00:00+00:00,0,1255,1255,54,-4.105
2017-03-07 20:00:00+00:00,0,1031,1031,45,-4.014
2017-03-07 21:00:00+00:00,0,1016,1016,42,-3.937
2017-03-07 22:00:00+00:00,0,1150,1150,37,-3.954
2017-03-07 23:00:00+00:00,0,1512,1512,35,-4.023
2017-03-08 00:00:00+00:00,0,1834,1834,33,-4.097
2017-03-08 01:00:00+00:00,0,1984,1984,32,-4.197
2017-03-08 02:00:00+00:00,0,1862,1862,31,-4.339
2017-03-08 03:00:00+00:00,0,1781,1781,32,-4.741
2017-03-08 04:00:00+00:00,0,1656,1656,33,-5.386
2017-03-08 05:00:00+00:00,1,1602,1603,39,-5.705
2017-03-08 06:00:00+00:00,44,1494,1538,47,-4.283
2017-03-08 07:00:00+00:00,127,1143,1270,49,-2.343
2017-03-08 08:00:00+00:00,228,1077,1305,46,-1.098
2017-03-08 09:00:00+00:00,311,913,1224,40,-0.002
2017-03-08 10:00:00+00:00,384,729,1113,38,1.082
2017-03-08 11:00:00+00:00,423,618,1041,34,2.036
2017-03-08 12:00:00+00:00,412,595,1007,32,2.645
2017-03-08 13:00:00+00:00,354,677,1031,32,2.797
2017-03-08 14:00:00+00:00,257,690,947,33,2.3
2017-03-08 15:00:00+00:00,148,412,560,32,1.577
2017-03-08 16:00:00+00:00,56,199,255,36,0.448
2017-03-08 17:00:00+00:00,15,134,149,39,-0.774
2017-03-08 18:00:00+00:00,0,95,95,41,-1.186
2017-03-08 19:00:00+00:00,0,85,85,37,-1.265
2017-03-08 20:00:00+00:00,0,76,76,33,-1.637
2017-03-08 21:00:00+00:00,0,98,98,29,-1.966
2017-03-08 22:00:00+00:00,0,138,138,26,-1.95
2017-03-08 23:00:00+00:00,0,320,320,29,-1.853
2017-03-09 00:00:00+00:00,0,604,604,28,-1.889
2017-03-09 01:00:00+00:00,0,649,649,28,-1.897
2017-03-09 02:00:00+00:00,0,512,512,28,-1.713
2017-03-09 03:00:00+00:00,0,604,604,30,-1.228
2017-03-09 04:00:00+00:00,0,528,528,32,-0.755
2017-03-09 05:00:00+00:00,1,516,517,39,-0.532
2017-03-09 06:00:00+00:00,35,483,518,48,-0.07
2017-03-09 07:00:00+00:00,96,470,566,50,0.514
2017-03-09 08:00:00+00:00,168,456,624,48,0.99
2017-03-09 09:00:00+00:00,226,514,740,45,1.513
2017-03-09 10:00:00+00:00,256,553,809,44,1.829
2017-03-09 11:00:00+00:00,257,412,669,40,2.1
2017-03-09 12:00:00+00:00,242,353,595,38,2.096
2017-03-09 13:00:00+00:00,204,311,515,37,1.959
2017-03-09 14:00:00+00:00,147,170,317,38,1.693
2017-03-09 15:00:00+00:00,86,139,225,37,1.219
2017-03-09 16:00:00+00:00,35,59,94,40,0.75
2017-03-09 17:00:00+00:00,12,76,88,44,0.087
2017-03-09 18:00:00+00:00,0,104,104,44,-0.33
2017-03-09 19:00:00+00:00,0,211,211,36,-0.723
2017-03-09 20:00:00+00:00,0,470,470,31,-1.105
2017-03-09 21:00:00+00:00,0,514,514,29,-1.224
2017-03-09 22:00:00+00:00,0,508,508,23,-1.202
2017-03-09 23:00:00+00:00,0,742,742,24,-1.064
2017-03-10 00:00:00+00:00,0,1054,1054,22,-0.475
2017-03-10 01:00:00+00:00,0,1123,1123,19,-0.284
2017-03-10 02:00:00+00:00,0,1739,1739,20,-0.554
2017-03-10 03:00:00+00:00,0,2262,2262,21,-1.154
2017-03-10 04:00:00+00:00,0,2179,2179,26,-1.767
2017-03-10 05:00:00+00:00,2,2025,2027,32,-2.192
2017-03-10 06:00:00+00:00,47,1843,1890,39,-2.251
2017-03-10 07:00:00+00:00,134,2128,2262,41,-1.935
2017-03-10 08:00:00+00:00,218,2422,2640,37,-1.685
2017-03-10 09:00:00+00:00,282,2453,2735,37,-1.368
2017-03-10 10:00:00+00:00,321,2374,2695,35,-1.088
2017-03-10 11:00:00+00:00,329,2395,2724,33,-0.841
2017-03-10 12:00:00+00:00,304,2432,2736,30,-0.853
2017-03-10 13:00:00+00:00,257,2324,2581,30,-1.05
2017-03-10 14:00:00+00:00,189,2227,2416,32,-1.424
2017-03-10 15:00:00+00:00,114,2312,2426,36,-1.978
2017-03-10 16:00:00+00:00,46,2380,2426,43,-2.665
2017-03-10 17:00:00+00:00,13,2361,2374,50,-3.288
2017-03-10 18:00:00+00:00,0,2452,2452,52,-3.708
2017-03-10 19:00:00+00:00,0,2470,2470,46,-4.347
2017-03-10 20:00:00+00:00,0,2347,2347,42,-4.756
2017-03-10 21:00:00+00:00,0,2332,2332,40,-4.829
2017-03-10 22:00:00+00:00,0,2249,2249,36,-5.062
2017-03-10 23:00:00+00:00,0,2028,2028,34,-5.281
2017-03-11 00:00:00+00:00,0,2172,2172,33,-5.541
2017-03-11 01:00:00+00:00,0,2261,2261,31,-5.789
2017-03-11 02:00:00+00:00,0,2040,2040,31,-6.081
2017-03-11 03:00:00+00:00,0,1888,1888,33,-6.535
2017-03-11 04:00:00+00:00,0,1661,1661,33,-7.254
2017-03-11 05:00:00+00:00,3,1655,1658,32,-8.039
2017-03-11 06:00:00+00:00,54,1505,1559,34,-6.984
2017-03-11 07:00:00+00:00,151,1270,1421,36,-3.752
2017-03-11 08:00:00+00:00,276,1259,1535,37,-1.855
2017-03-11 09:00:00+00:00,386,1491,1877,34,-0.484
2017-03-11 10:00:00+00:00,446,1589,2035,32,0.657
2017-03-11 11:00:00+00:00,445,1391,1836,30,1.627
2017-03-11 12:00:00+00:00,399,1247,1646,28,2.126
2017-03-11 13:00:00+00:00,328,1137,1465,29,2.221
2017-03-11 14:00:00+00:00,238,1011,1249,29,1.873
2017-03-11 15:00:00+00:00,137,888,1025,32,1.224
2017-03-11 16:00:00+00:00,54,669,723,39,-0.166
2017-03-11 17:00:00+00:00,15,560,575,45,-1.077
2017-03-11 18:00:00+00:00,0,439,439,46,-1.462
2017-03-11 19:00:00+00:00,0,366,366,41,-1.633
2017-03-11 20:00:00+00:00,0,453,453,35,-1.671
2017-03-11 21:00:00+00:00,0,674,674,34,-1.868
2017-03-11 22:00:00+00:00,0,863,863,30,-2.258
2017-03-11 23:00:00+00:00,0,838,838,30,-2.6
2017-03-12 00:00:00+00:00,0,743,743,28,-3.067
2017-03-12 01:00:00+00:00,0,730,730,25,-3.59
2017-03-12 02:00:00+00:00,0,613,613,24,-4.131
2017-03-12 03:00:00+00:00,0,689,689,25,-4.673
2017-03-12 04:00:00+00:00,0,789,789,24,-5.318
2017-03-12 05:00:00+00:00,3,837,840,24,-5.737
2017-03-12 06:00:00+00:00,54,762,816,23,-4.349
2017-03-12 07:00:00+00:00,155,670,825,27,-1.332
2017-03-12 08:00:00+00:00,277,530,807,24,0.557
2017-03-12 09:00:00+00:00,387,433,820,24,1.684
2017-03-12 10:00:00+00:00,455,320,775,21,2.322
2017-03-12 11:00:00+00:00,466,275,741,20,2.729
2017-03-12 12:00:00+00:00,434,256,690,14,2.914
2017-03-12 13:00:00+00:00,373,277,650,12,2.81
2017-03-12 14:00:00+00:00,279,272,551,18,2.302
2017-03-12 15:00:00+00:00,163,338,501,24,1.291
2017-03-12 16:00:00+00:00,65,375,440,33,-0.765
2017-03-12 17:00:00+00:00,17,508,525,38,-2.359
2017-03-12 18:00:00+00:00,0,518,518,40,-3.473
2017-03-12 19:00:00+00:00,0,442,442,37,-4.282
2017-03-12 20:00:00+00:00,0,389,389,34,-4.809
2017-03-12 21:00:00+00:00,0,361,361,35,-4.991
2017-03-12 22:00:00+00:00,0,335,335,31,-5.163
2017-03-12 23:00:00+00:00,0,253,253,28,-5.311
2017-03-13 00:00:00+00:00,0,194,194,28,-5.363
2017-03-13 01:00:00+00:00,0,173,173,26,-5.472
2017-03-13 02:00:00+00:00,0,193,193,26,-5.654
2017-03-13 03:00:00+00:00,0,214,214,27,-6.177
2017-03-13 04:00:00+00:00,0,205,205,29,-6.667
2017-03-13 05:00:00+00:00,4,246,250,41,-6.717
2017-03-13 06:00:00+00:00,58,323,381,49,-5.116
2017-03-13 07:00:00+00:00,162,251,413,47,-2.388
2017-03-13 08:00:00+00:00,295,273,568,42,0.262
2017-03-13 09:00:00+00:00,415,318,733,39,2.17
2017-03-13 10:00:00+00:00,494,294,788,38,3.275
2017-03-13 11:00:00+00:00,522,316,838,34,3.986
2017-03-13 12:00:00+00:00,496,420,916,33,4.36
2017-03-13 13:00:00+00:00,420,473,893,34,4.275
2017-03-13 14:00:00+00:00,306,431,737,36,3.727
2017-03-13 15:00:00+00:00,176,346,522,40,2.615
2017-03-13 16:00:00+00:00,70,312,382,47,0.751
2017-03-13 17:00:00+00:00,18,352,370,52,-0.102
2017-03-13 18:00:00+00:00,0,460,460,55,-0.451
2017-03-13 19:00:00+00:00,0,485,485,48,-0.834
2017-03-13 20:00:00+00:00,0,462,462,41,-1.277
2017-03-13 21:00:00+00:00,0,383,383,39,-1.661
2017-03-13 22:00:00+00:00,0,283,283,35,-2.002
2017-03-13 23:00:00+00:00,0,318,318,32,-2.504
2017-03-14 00:00:00+00:00,0,426,426,31,-2.857
2017-03-14 01:00:00+00:00,0,608,608,30,-2.964
2017-03-14 02:00:00+00:00,0,596,596,29,-3.342
2017-03-14 03:00:00+00:00,0,490,490,29,-3.857
2017-03-14 04:00:00+00:00,0,563,563,31,-4.49
2017-03-14 05:00:00+00:00,4,662,666,37,-4.883
2017-03-14 06:00:00+00:00,53,632,685,46,-2.247
2017-03-14 07:00:00+00:00,146,585,731,46,0.327
2017-03-14 08:00:00+00:00,264,613,877,42,1.52
2017-03-14 09:00:00+00:00,370,663,1033,39,2.342
2017-03-14 10:00:00+00:00,437,748,1185,36,2.553
2017-03-14 11:00:00+00:00,447,810,1257,32,2.584
2017-03-14 12:00:00+00:00,400,996,1396,30,2.487
2017-03-14 13:00:00+00:00,327,1582,1909,30,2.316
2017-03-14 14:00:00+00:00,235,1997,2232,30,2.273
2017-03-14 15:00:00+00:00,135,1719,1854,33,1.785
2017-03-14 16:00:00+00:00,54,1415,1469,38,-0.077
2017-03-14 17:00:00+00:00,15,1258,1273,44,-1.298
2017-03-14 18:00:00+00:00,0,1321,1321,45,-1.377
2017-03-14 19:00:00+00:00,0,1344,1344,37,-1.384
2017-03-14 20:00:00+00:00,0,1091,1091,33,-1.383
2017-03-14 21:00:00+00:00,0,701,701,31,-1.472
2017-03-14 22:00:00+00:00,0,530,530,24,-1.632
2017-03-14 23:00:00+00:00,0,513,513,24,-1.997
2017-03-15 00:00:00+00:00,0,542,542,21,-2.152
2017-03-15 01:00:00+00:00,0,442,442,20,-1.856
2017-03-15 02:00:00+00:00,0,478,478,21,-1.705
2017-03-15 03:00:00+00:00,0,598,598,24,-1.698
2017-03-15 04:00:00+00:00,0,719,719,28,-2.055
2017-03-15 05:00:00+00:00,5,783,788,35,-2.443
2017-03-15 06:00:00+00:00,55,884,939,42,-0.012
2017-03-15 07:00:00+00:00,139,831,970,43,2.11
2017-03-15 08:00:00+00:00,239,887,1126,39,3.598
2017-03-15 09:00:00+00:00,330,1050,1380,36,4.672
2017-03-15 10:00:00+00:00,397,1004,1401,34,5.04
2017-03-15 11:00:00+00:00,424,1028,1452,30,5.258
2017-03-15 12:00:00+00:00,404,1230,1634,30,5.427
2017-03-15 13:00:00+00:00,340,1310,1650,30,5.082
2017-03-15 14:00:00+00:00,244,1417,1661,30,4.307
2017-03-15 15:00:00+00:00,140,1350,1490,32,3.602
2017-03-15 16:00:00+00:00,57,1242,1299,39,1.607
2017-03-15 17:00:00+00:00,16,1593,1609,46,0.061
2017-03-15 18:00:00+00:00,0,1799,1799,49,0.072
2017-03-15 19:00:00+00:00,0,1884,1884,42,0.254
2017-03-15 20:00:00+00:00,0,1826,1826,37,0.296
2017-03-15 21:00:00+00:00,0,1569,1569,34,0.243
2017-03-15 22:00:00+00:00,0,1290,1290,30,0.145
2017-03-15 23:00:00+00:00,0,1023,1023,30,-0.279
2017-03-16 00:00:00+00:00,0,879,879,28,-0.694
2017-03-16 01:00:00+00:00,0,756,756,28,-1.14
2017-03-16 02:00:00+00:00,0,775,775,27,-1.223
2017-03-16 03:00:00+00:00,0,812,812,27,-1.134
2017-03-16 04:00:00+00:00,0,708,708,31,-1.342
2017-03-16 05:00:00+00:00,5,671,676,37,-1.584
2017-03-16 06:00:00+00:00,48,720,768,42,0.037
2017-03-16 07:00:00+00:00,142,544,686,43,2.947
2017-03-16 08:00:00+00:00,267,559,826,38,5.142
2017-03-16 09:00:00+00:00,377,801,1178,34,6.656
2017-03-16 10:00:00+00:00,449,1245,1694,32,7.725
2017-03-16 11:00:00+00:00,494,1404,1898,30,8.323
2017-03-16 12:00:00+00:00,497,1511,2008,30,8.419
2017-03-16 13:00:00+00:00,440,1515,1955,30,8.096
2017-03-16 14:00:00+00:00,325,1550,1875,32,7.338
2017-03-16 15:00:00+00:00,181,1516,1697,33,6.045
2017-03-16 16:00:00+00:00,66,1233,1299,41,4.053
2017-03-16 17:00:00+00:00,12,983,995,48,3.341
2017-03-16 18:00:00+00:00,0,871,871,50,2.981
2017-03-16 19:00:00+00:00,0,576,576,43,2.437
2017-03-16 20:00:00+00:00,0,342,342,35,1.953
2017-03-16 21:00:00+00:00,0,294,294,31,1.652
2017-03-16 22:00:00+00:00,0,257,257,27,1.591
2017-03-16 23:00:00+00:00,0,193,193,24,1.635
2017-03-17 00:00:00+00:00,0,80,80,22,1.669
2017-03-17 01:00:00+00:00,0,44,44,19,1.619
2017-03-17 02:00:00+00:00,0,48,48,20,1.467
2017-03-17 03:00:00+00:00,0,88,88,23,1.192
2017-03-17 04:00:00+00:00,0,178,178,27,0.961
2017-03-17 05:00:00+00:00,9,342,351,33,1.006
2017-03-17 06:00:00+00:00,75,548,623,38,2.613
2017-03-17 07:00:00+00:00,191,529,720,38,5.593
2017-03-17 08:00:00+00:00,330,465,795,36,7.596
2017-03-17 09:00:00+00:00,447,575,1022,33,8.799
2017-03-17 10:00:00+00:00,518,532,1050,32,9.723
2017-03-17 11:00:00+00:00,536,542,1078,29,10.266
2017-03-17 12:00:00+00:00,499,548,1047,26,10.383
2017-03-17 13:00:00+00:00,413,732,1145,26,10.134
2017-03-17 14:00:00+00:00,289,890,1179,27,9.321
2017-03-17 15:00:00+00:00,157,946,1103,28,7.404
2017-03-17 16:00:00+00:00,63,690,753,35,5.084
2017-03-17 17:00:00+00:00,18,542,560,39,3.429
2017-03-17 18:00:00+00:00,0,560,560,40,2.893
2017-03-17 19:00:00+00:00,0,1317,1317,33,2.712
2017-03-17 20:00:00+00:00,0,1114,1114,28,2.814
2017-03-17 21:00:00+00:00,0,867,867,26,2.441
2017-03-17 22:00:00+00:00,0,1142,1142,17,2.007
2017-03-17 23:00:00+00:00,0,1480,1480,4,1.65
2017-03-18 00:00:00+00:00,0,1199,1199,-1,1.535
2017-03-18 01:00:00+00:00,0,736,736,-3,1.241
2017-03-18 02:00:00+00:00,0,392,392,-5,1.206
2017-03-18 03:00:00+00:00,0,153,153,-4,0.876
2017-03-18 04:00:00+00:00,0,115,115,-3,0.054
2017-03-18 05:00:00+00:00,6,150,156,-2,0.468
2017-03-18 06:00:00+00:00,49,483,532,7,2.614
2017-03-18 07:00:00+00:00,110,1028,1138,13,3.403
2017-03-18 08:00:00+00:00,171,1042,1213,20,3.932
2017-03-18 09:00:00+00:00,222,1259,1481,24,4.578
2017-03-18 10:00:00+00:00,271,1999,2270,24,5.555
2017-03-18 11:00:00+00:00,301,2311,2612,22,5.507
2017-03-18 12:00:00+00:00,289,2369,2658,20,5.142
2017-03-18 13:00:00+00:00,253,2421,2674,17,4.927
2017-03-18 14:00:00+00:00,198,2509,2707,16,4.594
2017-03-18 15:00:00+00:00,129,2538,2667,17,3.404
2017-03-18 16:00:00+00:00,59,2482,2541,27,2.312
2017-03-18 17:00:00+00:00,18,2355,2373,33,0.896
2017-03-18 18:00:00+00:00,0,2337,2337,37,0.369
2017-03-18 19:00:00+00:00,0,2282,2282,33,0.65
2017-03-18 20:00:00+00:00,0,2142,2142,29,0.356
2017-03-18 21:00:00+00:00,0,2108,2108,29,0.318
2017-03-18 22:00:00+00:00,0,1765,1765,25,0.884
2017-03-18 23:00:00+00:00,0,1506,1506,24,0.921
2017-03-19 00:00:00+00:00,0,1477,1477,22,0.972
2017-03-19 01:00:00+00:00,0,965,965,18,0.976
2017-03-19 02:00:00+00:00,0,806,806,17,0.895
2017-03-19 03:00:00+00:00,0,1072,1072,16,0.779
2017-03-19 04:00:00+00:00,0,732,732,16,0.82
2017-03-19 05:00:00+00:00,7,672,679,15,1.122
2017-03-19 06:00:00+00:00,53,798,851,15,2.009
2017-03-19 07:00:00+00:00,120,508,628,16,2.9
2017-03-19 08:00:00+00:00,180,373,553,18,3.798
2017-03-19 09:00:00+00:00,222,320,542,17,4.813
2017-03-19 10:00:00+00:00,263,229,492,19,5.837
2017-03-19 11:00:00+00:00,276,180,456,5,6.648
2017-03-19 12:00:00+00:00,271,125,396,3,6.993
2017-03-19 13:00:00+00:00,241,127,368,1,7.105
2017-03-19 14:00:00+00:00,197,148,345,-1,7.065
2017-03-19 15:00:00+00:00,130,194,324,2,6.498
2017-03-19 16:00:00+00:00,58,339,397,13,4.374
2017-03-19 17:00:00+00:00,18,498,516,19,2.638
2017-03-19 18:00:00+00:00,0,579,579,23,2.266
2017-03-19 19:00:00+00:00,0,673,673,15,1.871
2017-03-19 20:00:00+00:00,0,857,857,12,1.535
2017-03-19 21:00:00+00:00,0,903,903,12,1.334
2017-03-19 22:00:00+00:00,0,885,885,8,0.781
2017-03-19 23:00:00+00:00,0,856,856,-5,0.961
2017-03-20 00:00:00+00:00,0,1024,1024,1,1.208
2017-03-20 01:00:00+00:00,0,1163,1163,1,1.39
2017-03-20 02:00:00+00:00,0,1101,1101,1,1.438
2017-03-20 03:00:00+00:00,0,1228,1228,2,1.476
2017-03-20 04:00:00+00:00,0,1478,1478,13,1.503
2017-03-20 05:00:00+00:00,11,1385,1396,32,1.673
2017-03-20 06:00:00+00:00,76,1145,1221,40,2.766
2017-03-20 07:00:00+00:00,177,868,1045,39,3.83
2017-03-20 08:00:00+00:00,287,1002,1289,35,5.105
2017-03-20 09:00:00+00:00,372,1165,1537,32,6.579
2017-03-20 10:00:00+00:00,427,1013,1440,31,8.265
2017-03-20 11:00:00+00:00,441,721,1162,29,10.153
2017-03-20 12:00:00+00:00,410,833,1243,27,11.05
2017-03-20 13:00:00+00:00,348,857,1205,27,11.117
2017-03-20 14:00:00+00:00,260,792,1052,28,10.72
2017-03-20 15:00:00+00:00,157,548,705,29,9.804
2017-03-20 16:00:00+00:00,68,268,336,33,7.309
2017-03-20 17:00:00+00:00,19,211,230,38,5.397
2017-03-20 18:00:00+00:00,0,203,203,41,4.83
2017-03-20 19:00:00+00:00,0,192,192,34,4.469
2017-03-20 20:00:00+00:00,0,180,180,31,4.171
2017-03-20 21:00:00+00:00,0,207,207,27,3.945
2017-03-20 22:00:00+00:00,0,255,255,22,3.749
2017-03-20 23:00:00+00:00,0,352,352,14,3.415
2017-03-21 00:00:00+00:00,0,333,333,12,3.2
2017-03-21 01:00:00+00:00,0,200,200,14,3.085
2017-03-21 02:00:00+00:00,0,154,154,15,2.861
2017-03-21 03:00:00+00:00,0,148,148,19,2.695
2017-03-21 04:00:00+00:00,0,215,215,24,2.546
2017-03-21 05:00:00+00:00,10,457,467,32,2.622
2017-03-21 06:00:00+00:00,67,548,615,36,3.219
2017-03-21 07:00:00+00:00,152,522,674,37,4.053
2017-03-21 08:00:00+00:00,251,755,1006,34,5.492
2017-03-21 09:00:00+00:00,331,697,1028,31,6.97
2017-03-21 10:00:00+00:00,384,518,902,30,8.323
2017-03-21 11:00:00+00:00,405,341,746,27,9.488
2017-03-21 12:00:00+00:00,375,151,526,27,10.07
2017-03-21 13:00:00+00:00,313,76,389,28,9.874
2017-03-21 14:00:00+00:00,232,58,290,30,8.997
2017-03-21 15:00:00+00:00,139,71,210,33,7.622
2017-03-21 16:00:00+00:00,61,126,187,37,5.586
2017-03-21 17:00:00+00:00,18,172,190,44,3.767
2017-03-21 18:00:00+00:00,0,284,284,49,3.366
2017-03-21 19:00:00+00:00,0,436,436,43,3.041
2017-03-21 20:00:00+00:00,0,487,487,38,2.79
2017-03-21 21:00:00+00:00,0,308,308,35,2.643
2017-03-21 22:00:00+00:00,0,171,171,30,2.382
2017-03-21 23:00:00+00:00,0,49,49,31,2.154
2017-03-22 00:00:00+00:00,0,70,70,29,1.959
2017-03-22 01:00:00+00:00,0,178,178,28,1.79
2017-03-22 02:00:00+00:00,0,381,381,27,1.698
2017-03-22 03:00:00+00:00,0,600,600,29,1.659
2017-03-22 04:00:00+00:00,0,769,769,31,1.631
2017-03-22 05:00:00+00:00,10,726,736,39,1.665
2017-03-22 06:00:00+00:00,63,467,530,45,2.296
2017-03-22 07:00:00+00:00,133,448,581,45,3.059
2017-03-22 08:00:00+00:00,194,640,834,42,4.09
2017-03-22 09:00:00+00:00,255,678,933,40,5.317
2017-03-22 10:00:00+00:00,298,718,1016,40,6.167
2017-03-22 11:00:00+00:00,323,865,1188,37,6.72
2017-03-22 12:00:00+00:00,314,1035,1349,37,7.085
2017-03-22 13:00:00+00:00,275,920,1195,37,6.951
2017-03-22 14:00:00+00:00,220,749,969,39,6.477
2017-03-22 15:00:00+00:00,143,733,876,39,5.669
2017-03-22 16:00:00+00:00,66,713,779,43,4.27
2017-03-22 17:00:00+00:00,19,705,724,47,2.959
2017-03-22 18:00:00+00:00,0,667,667,48,2.271
2017-03-22 19:00:00+00:00,0,537,537,41,1.452
2017-03-22 20:00:00+00:00,0,515,515,35,0.863
2017-03-22 21:00:00+00:00,0,390,390,33,0.469
2017-03-22 22:00:00+00:00,0,309,309,29,0.278
2017-03-22 23:00:00+00:00,0,216,216,30,0.18
2017-03-23 00:00:00+00:00,0,142,142,30,0.179
2017-03-23 01:00:00+00:00,0,134,134,28,0.102
2017-03-23 02:00:00+00:00,0,118,118,28,0.07
2017-03-23 03:00:00+00:00,0,112,112,28,0.164
2017-03-23 04:00:00+00:00,0,100,100,31,0.292
2017-03-23 05:00:00+00:00,12,98,110,36,0.69
2017-03-23 06:00:00+00:00,72,64,136,42,2.056
2017-03-23 07:00:00+00:00,165,36,201,43,3.195
2017-03-23 08:00:00+00:00,273,30,303,40,4.421
2017-03-23 09:00:00+00:00,395,56,451,36,5.468
2017-03-23 10:00:00+00:00,482,65,547,35,6.388
2017-03-23 11:00:00+00:00,515,96,611,33,7.22
2017-03-23 12:00:00+00:00,493,169,662,33,7.796
2017-03-23 13:00:00+00:00,421,239,660,32,7.952
2017-03-23 14:00:00+00:00,316,271,587,34,7.656
2017-03-23 15:00:00+00:00,192,197,389,34,6.967
2017-03-23 16:00:00+00:00,83,222,305,40,4.928
2017-03-23 17:00:00+00:00,22,287,309,44,2.099
2017-03-23 18:00:00+00:00,0,374,374,45,1.074
2017-03-23 19:00:00+00:00,0,384,384,41,0.395
2017-03-23 20:00:00+00:00,0,392,392,36,0.125
2017-03-23 21:00:00+00:00,0,414,414,35,-0.127
2017-03-23 22:00:00+00:00,0,452,452,31,-0.472
2017-03-23 23:00:00+00:00,0,516,516,31,-0.678
2017-03-24 00:00:00+00:00,0,702,702,30,-0.747
2017-03-24 01:00:00+00:00,0,878,878,29,-0.861
2017-03-24 02:00:00+00:00,0,932,932,29,-0.605
2017-03-24 03:00:00+00:00,0,1026,1026,30,-0.524
2017-03-24 04:00:00+00:00,0,1198,1198,31,-0.324
2017-03-24 05:00:00+00:00,16,1315,1331,38,0.277
2017-03-24 06:00:00+00:00,90,1296,1386,43,2.779
2017-03-24 07:00:00+00:00,203,1243,1446,43,5.867
2017-03-24 08:00:00+00:00,340,1187,1527,40,9.515
2017-03-24 09:00:00+00:00,454,1166,1620,36,10.972
2017-03-24 10:00:00+00:00,522,1213,1735,33,11.888
2017-03-24 11:00:00+00:00,537,1391,1928,31,12.356
2017-03-24 12:00:00+00:00,510,1337,1847,29,12.544
2017-03-24 13:00:00+00:00,440,1314,1754,29,12.242
2017-03-24 14:00:00+00:00,331,1269,1600,31,11.478
2017-03-24 15:00:00+00:00,202,1112,1314,32,10.139
2017-03-24 16:00:00+00:00,88,1106,1194,36,7.509
2017-03-24 17:00:00+00:00,24,1192,1216,40,5.189
2017-03-24 18:00:00+00:00,0,1370,1370,42,4.296
2017-03-24 19:00:00+00:00,0,1469,1469,37,3.691
2017-03-24 20:00:00+00:00,0,1375,1375,33,3.227
2017-03-24 21:00:00+00:00,0,1372,1372,33,2.911
2017-03-24 22:00:00+00:00,0,1430,1430,31,2.546
2017-03-24 23:00:00+00:00,0,1354,1354,29,2.401
2017-03-25 00:00:00+00:00,0,1288,1288,28,2.188
2017-03-25 01:00:00+00:00,0,1222,1222,27,2.095
2017-03-25 02:00:00+00:00,0,1042,1042,27,1.897
2017-03-25 03:00:00+00:00,0,811,811,26,1.678
2017-03-25 04:00:00+00:00,0,762,762,27,1.557
2017-03-25 05:00:00+00:00,19,574,593,26,1.758
2017-03-25 06:00:00+00:00,101,339,440,26,3.538
2017-03-25 07:00:00+00:00,225,163,388,28,5.997
2017-03-25 08:00:00+00:00,366,120,486,27,9.091
2017-03-25 09:00:00+00:00,486,102,588,27,10.755
2017-03-25 10:00:00+00:00,565,70,635,24,11.801
2017-03-25 11:00:00+00:00,591,89,680,20,12.433
2017-03-25 12:00:00+00:00,563,117,680,16,12.611
2017-03-25 13:00:00+00:00,483,133,616,13,12.285
2017-03-25 14:00:00+00:00,361,197,558,16,11.372
2017-03-25 15:00:00+00:00,217,253,470,19,9.913
2017-03-25 16:00:00+00:00,95,221,316,30,7.55
2017-03-25 17:00:00+00:00,26,217,243,35,4.567
2017-03-25 18:00:00+00:00,0,273,273,38,3.711
2017-03-25 19:00:00+00:00,0,513,513,34,3.308
2017-03-25 20:00:00+00:00,0,731,731,31,3.164
2017-03-25 21:00:00+00:00,0,746,746,32,3.208
2017-03-25 22:00:00+00:00,0,816,816,28,3.195
2017-03-25 23:00:00+00:00,0,890,890,24,3.204
2017-03-26 00:00:00+00:00,0,854,854,22,3.148
2017-03-26 01:00:00+00:00,0,847,847,21,2.909
2017-03-26 02:00:00+00:00,0,1099,1099,,2.573
2017-03-26 03:00:00+00:00,0,1407,1407,,2.048
2017-03-26 04:00:00+00:00,0,1421,1421,20,1.644
2017-03-26 05:00:00+00:00,27,1113,1140,21,1.696
2017-03-26 06:00:00+00:00,94,999,1093,24,2.965
2017-03-26 07:00:00+00:00,200,1040,1240,24,4.41
2017-03-26 08:00:00+00:00,301,1076,1377,23,6.063
2017-03-26 09:00:00+00:00,412,1140,1552,23,7.196
2017-03-26 10:00:00+00:00,493,1062,1555,21,7.883
2017-03-26 11:00:00+00:00,518,950,1468,18,7.938
2017-03-26 12:00:00+00:00,504,826,1330,13,7.731
2017-03-26 13:00:00+00:00,444,949,1393,16,7.309
2017-03-26 14:00:00+00:00,337,1020,1357,18,6.548
2017-03-26 15:00:00+00:00,212,865,1077,25,5.375
2017-03-26 16:00:00+00:00,99,709,808,35,3.325
2017-03-26 17:00:00+00:00,20,542,562,39,0.202
2017-03-26 18:00:00+00:00,0,526,526,37,-0.502
2017-03-26 19:00:00+00:00,0,472,472,34,-0.901
2017-03-26 20:00:00+00:00,0,400,400,34,-1.307
2017-03-26 21:00:00+00:00,0,271,271,30,-1.602
2017-03-26 22:00:00+00:00,0,279,279,29,-1.775
2017-03-26 23:00:00+00:00,0,299,299,27,-1.932
2017-03-27 00:00:00+00:00,0,324,324,26,-2.083
2017-03-27 01:00:00+00:00,0,219,219,27,-2.257
2017-03-27 02:00:00+00:00,0,108,108,28,-2.409
2017-03-27 03:00:00+00:00,0,87,87,30,-2.783
2017-03-27 04:00:00+00:00,0,64,64,41,-3.303
2017-03-27 05:00:00+00:00,30,76,106,47,-2.55
2017-03-27 06:00:00+00:00,114,65,179,44,0.285
2017-03-27 07:00:00+00:00,254,41,295,40,2.965
2017-03-27 08:00:00+00:00,399,35,434,33,5.19
2017-03-27 09:00:00+00:00,515,36,551,31,6.841
2017-03-27 10:00:00+00:00,586,33,619,28,8.197
2017-03-27 11:00:00+00:00,605,26,631,28,9.174
2017-03-27 12:00:00+00:00,568,17,585,28,9.694
2017-03-27 13:00:00+00:00,480,19,499,29,9.656
2017-03-27 14:00:00+00:00,354,17,371,29,9.023
2017-03-27 15:00:00+00:00,218,17,235,35,8.101
2017-03-27 16:00:00+00:00,100,18,118,40,5.201
2017-03-27 17:00:00+00:00,20,26,46,45,2.988
2017-03-27 18:00:00+00:00,1,31,32,43,2.026
2017-03-27 19:00:00+00:00,0,39,39,39,1.217
2017-03-27 20:00:00+00:00,0,56,56,35,0.633
2017-03-27 21:00:00+00:00,0,48,48,30,0.084
2017-03-27 22:00:00+00:00,0,46,46,30,-0.518
2017-03-27 23:00:00+00:00,0,45,45,29,-0.933
2017-03-28 00:00:00+00:00,0,36,36,29,-1.064
2017-03-28 01:00:00+00:00,0,28,28,28,-0.975
2017-03-28 02:00:00+00:00,0,25,25,29,-0.692
2017-03-28 03:00:00+00:00,0,17,17,32,-0.518
2017-03-28 04:00:00+00:00,0,11,11,40,-0.369
2017-03-28 05:00:00+00:00,33,13,46,50,0.426
2017-03-28 06:00:00+00:00,118,11,129,49,3.146
2017-03-28 07:00:00+00:00,256,1,257,42,6.145
2017-03-28 08:00:00+00:00,399,1,400,36,8.48
2017-03-28 09:00:00+00:00,512,2,514,33,10.095
2017-03-28 10:00:00+00:00,582,5,587,30,11.342
2017-03-28 11:00:00+00:00,598,6,604,30,12.11
2017-03-28 12:00:00+00:00,560,7,567,29,12.389
2017-03-28 13:00:00+00:00,473,8,481,28,12.214
2017-03-28 14:00:00+00:00,347,9,356,29,11.496
2017-03-28 15:00:00+00:00,214,12,226,32,10.38
2017-03-28 16:00:00+00:00,99,25,124,37,7.909
2017-03-28 17:00:00+00:00,20,46,66,42,5.748
2017-03-28 18:00:00+00:00,1,66,67,41,5.199
2017-03-28 19:00:00+00:00,0,178,178,36,4.34
2017-03-28 20:00:00+00:00,0,301,301,32,3.371
2017-03-28 21:00:00+00:00,0,406,406,28,2.577
2017-03-28 22:00:00+00:00,0,559,559,27,2.096
2017-03-28 23:00:00+00:00,0,808,808,25,1.844
2017-03-29 00:00:00+00:00,0,1152,1152,23,1.83
2017-03-29 01:00:00+00:00,0,1281,1281,21,1.954
2017-03-29 02:00:00+00:00,0,1357,1357,23,2.007
2017-03-29 03:00:00+00:00,0,1261,1261,26,1.843
2017-03-29 04:00:00+00:00,1,1155,1156,30,1.559
2017-03-29 05:00:00+00:00,34,999,1033,35,1.881
2017-03-29 06:00:00+00:00,117,735,852,35,4.339
2017-03-29 07:00:00+00:00,249,533,782,31,6.635
2017-03-29 08:00:00+00:00,385,477,862,27,8.183
2017-03-29 09:00:00+00:00,494,498,992,26,9.321
2017-03-29 10:00:00+00:00,559,740,1299,23,10.164
2017-03-29 11:00:00+00:00,572,1090,1662,23,10.895
2017-03-29 12:00:00+00:00,532,1266,1798,25,11.231
2017-03-29 13:00:00+00:00,445,1239,1684,27,11.118
2017-03-29 14:00:00+00:00,322,1295,1617,29,10.51
2017-03-29 15:00:00+00:00,200,1622,1822,32,9.404
2017-03-29 16:00:00+00:00,95,1574,1669,37,7.104
2017-03-29 17:00:00+00:00,20,1441,1461,41,4.332
2017-03-29 18:00:00+00:00,0,1266,1266,40,3.963
2017-03-29 19:00:00+00:00,0,1055,1055,37,3.601
2017-03-29 20:00:00+00:00,0,1077,1077,35,2.954
2017-03-29 21:00:00+00:00,0,1194,1194,31,2.435
2017-03-29 22:00:00+00:00,0,1352,1352,29,2.02
2017-03-29 23:00:00+00:00,0,1608,1608,28,1.731
2017-03-30 00:00:00+00:00,0,1512,1512,27,1.589
2017-03-30 01:00:00+00:00,0,1194,1194,27,1.596
2017-03-30 02:00:00+00:00,0,841,841,27,1.714
2017-03-30 03:00:00+00:00,0,720,720,30,1.86
2017-03-30 04:00:00+00:00,1,718,719,36,1.883
2017-03-30 05:00:00+00:00,35,618,653,43,2.533
2017-03-30 06:00:00+00:00,116,492,608,44,4.66
2017-03-30 07:00:00+00:00,233,331,564,41,6.543
2017-03-30 08:00:00+00:00,351,273,624,39,8.661
2017-03-30 09:00:00+00:00,448,277,725,37,10.523
2017-03-30 10:00:00+00:00,506,306,812,32,11.92
2017-03-30 11:00:00+00:00,504,324,828,31,12.845
2017-03-30 12:00:00+00:00,460,260,720,29,13.172
2017-03-30 13:00:00+00:00,394,198,592,30,12.934
2017-03-30 14:00:00+00:00,307,132,439,29,12.265
2017-03-30 15:00:00+00:00,199,73,272,31,11.171
2017-03-30 16:00:00+00:00,94,47,141,36,9.058
2017-03-30 17:00:00+00:00,19,67,86,41,6.602
2017-03-30 18:00:00+00:00,0,75,75,40,5.72
2017-03-30 19:00:00+00:00,0,82,82,34,4.868
2017-03-30 20:00:00+00:00,0,69,69,31,4.022
2017-03-30 21:00:00+00:00,0,65,65,27,3.365
2017-03-30 22:00:00+00:00,0,118,118,26,2.707
2017-03-30 23:00:00+00:00,0,199,199,24,2.035
2017-03-31 00:00:00+00:00,0,261,261,24,1.491
2017-03-31 01:00:00+00:00,0,344,344,24,0.988
2017-03-31 02:00:00+00:00,0,447,447,25,0.539
2017-03-31 03:00:00+00:00,0,571,571,27,0.324
2017-03-31 04:00:00+00:00,1,669,670,32,0.379
2017-03-31 05:00:00+00:00,41,755,796,40,1.8
2017-03-31 06:00:00+00:00,136,705,841,40,3.768
2017-03-31 07:00:00+00:00,273,635,908,37,5.943
2017-03-31 08:00:00+00:00,409,767,1176,34,9.101
2017-03-31 09:00:00+00:00,516,1002,1518,33,11.847
2017-03-31 10:00:00+00:00,581,1293,1874,30,13.447
2017-03-31 11:00:00+00:00,598,1485,2083,28,14.357
2017-03-31 12:00:00+00:00,565,1388,1953,26,14.717
2017-03-31 13:00:00+00:00,485,1348,1833,26,14.528
2017-03-31 14:00:00+00:00,370,1356,1726,28,13.767
2017-03-31 15:00:00+00:00,234,1359,1593,32,13.172
2017-03-31 16:00:00+00:00,108,1299,1407,36,10.544
2017-03-31 17:00:00+00:00,22,1362,1384,40,7.374
2017-03-31 18:00:00+00:00,1,1548,1549,39,5.765
2017-03-31 19:00:00+00:00,0,1646,1646,35,4.429
2017-03-31 20:00:00+00:00,0,1613,1613,33,3.248
2017-03-31 21:00:00+00:00,0,1681,1681,31,2.387
2017-03-31 22:00:00+00:00,0,1673,1673,29,1.684
2017-03-31 23:00:00+00:00,0,1629,1629,28,1.301
2017-04-01 00:00:00+00:00,0,1708,1708,27,1.133
2017-04-01 01:00:00+00:00,0,1701,1701,28,1.439
2017-04-01 02:00:00+00:00,0,1623,1623,28,1.532
2017-04-01 03:00:00+00:00,0,1647,1647,29,1.382
2017-04-01 04:00:00+00:00,1,1567,1568,29,1.237
2017-04-01 05:00:00+00:00,43,1416,1459,31,2.087
2017-04-01 06:00:00+00:00,142,1282,1424,36,4.019
2017-04-01 07:00:00+00:00,278,1276,1554,36,6.957
2017-04-01 08:00:00+00:00,410,1520,1930,34,9.27
2017-04-01 09:00:00+00:00,511,1957,2468,30,10.717
2017-04-01 10:00:00+00:00,570,2073,2643,29,11.529
2017-04-01 11:00:00+00:00,585,2111,2696,28,11.798
2017-04-01 12:00:00+00:00,552,2098,2650,26,11.588
2017-04-01 13:00:00+00:00,475,2031,2506,26,11.019
2017-04-01 14:00:00+00:00,363,2026,2389,27,10.143
2017-04-01 15:00:00+00:00,230,2000,2230,30,8.946
2017-04-01 16:00:00+00:00,106,1849,1955,34,6.943
2017-04-01 17:00:00+00:00,22,1856,1878,39,3.814
2017-04-01 18:00:00+00:00,1,1899,1900,41,2.736
2017-04-01 19:00:00+00:00,0,2015,2015,38,2.215
2017-04-01 20:00:00+00:00,0,1919,1919,37,1.758
2017-04-01 21:00:00+00:00,0,1868,1868,33,1.478
2017-04-01 22:00:00+00:00,0,1822,1822,29,1.084
2017-04-01 23:00:00+00:00,0,1550,1550,28,0.528
2017-04-02 00:00:00+00:00,0,1108,1108,27,0.147
2017-04-02 01:00:00+00:00,0,902,902,26,0.25
2017-04-02 02:00:00+00:00,0,825,825,26,0.607
2017-04-02 03:00:00+00:00,0,719,719,26,0.853
2017-04-02 04:00:00+00:00,1,542,543,26,1.028
2017-04-02 05:00:00+00:00,43,411,454,27,1.853
2017-04-02 06:00:00+00:00,135,347,482,28,4.65
2017-04-02 07:00:00+00:00,263,162,425,29,7.388
2017-04-02 08:00:00+00:00,388,131,519,29,9.368
2017-04-02 09:00:00+00:00,486,105,591,28,10.673
2017-04-02 10:00:00+00:00,544,121,665,26,11.613
2017-04-02 11:00:00+00:00,557,199,756,22,12.011
2017-04-02 12:00:00+00:00,527,290,817,19,11.944
2017-04-02 13:00:00+00:00,457,355,812,20,11.379
2017-04-02 14:00:00+00:00,355,361,716,19,10.548
2017-04-02 15:00:00+00:00,230,335,565,27,9.726
2017-04-02 16:00:00+00:00,110,256,366,32,8.052
2017-04-02 17:00:00+00:00,23,190,213,35,6.675
2017-04-02 18:00:00+00:00,1,137,138,37,6.437
2017-04-02 19:00:00+00:00,0,146,146,37,6.187
2017-04-02 20:00:00+00:00,0,174,174,37,5.789
2017-04-02 21:00:00+00:00,0,132,132,31,5.161
2017-04-02 22:00:00+00:00,0,67,67,28,4.545
2017-04-02 23:00:00+00:00,0,48,48,27,4.055
2017-04-03 00:00:00+00:00,0,101,101,26,3.639
2017-04-03 01:00:00+00:00,0,258,258,26,3.31
2017-04-03 02:00:00+00:00,0,303,303,27,3.024
2017-04-03 03:00:00+00:00,0,256,256,30,2.529
2017-04-03 04:00:00+00:00,1,278,279,41,2.113
2017-04-03 05:00:00+00:00,43,336,379,48,2.971
2017-04-03 06:00:00+00:00,132,342,474,48,5.595
2017-04-03 07:00:00+00:00,249,269,518,43,7.306
2017-04-03 08:00:00+00:00,367,286,653,41,8.622
2017-04-03 09:00:00+00:00,463,354,817,39,9.362
2017-04-03 10:00:00+00:00,516,444,960,34,9.849
2017-04-03 11:00:00+00:00,518,484,1002,33,10.231
2017-04-03 12:00:00+00:00,479,465,944,33,10.312
2017-04-03 13:00:00+00:00,384,436,820,32,9.829
2017-04-03 14:00:00+00:00,266,430,696,32,8.797
2017-04-03 15:00:00+00:00,181,576,757,36,7.44
2017-04-03 16:00:00+00:00,99,876,975,40,6.089
2017-04-03 17:00:00+00:00,22,1310,1332,43,4.615
2017-04-03 18:00:00+00:00,1,1450,1451,46,4.07
2017-04-03 19:00:00+00:00,0,1379,1379,42,3.779
2017-04-03 20:00:00+00:00,0,1151,1151,39,3.401
2017-04-03 21:00:00+00:00,0,1063,1063,32,3.016
2017-04-03 22:00:00+00:00,0,869,869,32,2.471
2017-04-03 23:00:00+00:00,0,700,700,32,2.067
2017-04-04 00:00:00+00:00,0,784,784,31,1.411
2017-04-04 01:00:00+00:00,0,951,951,31,0.852
2017-04-04 02:00:00+00:00,0,1146,1146,30,0.64
2017-04-04 03:00:00+00:00,0,1228,1228,33,0.518
2017-04-04 04:00:00+00:00,1,1222,1223,43,0.405
2017-04-04 05:00:00+00:00,39,1157,1196,52,1.01
2017-04-04 06:00:00+00:00,114,1008,1122,53,1.959
2017-04-04 07:00:00+00:00,212,927,1139,49,2.725
2017-04-04 08:00:00+00:00,312,973,1285,44,3.865
2017-04-04 09:00:00+00:00,390,1125,1515,42,5.422
2017-04-04 10:00:00+00:00,435,1237,1672,36,6.718
2017-04-04 11:00:00+00:00,443,1324,1767,35,7.018
2017-04-04 12:00:00+00:00,429,1346,1775,35,6.255
2017-04-04 13:00:00+00:00,380,1476,1856,34,5.204
2017-04-04 14:00:00+00:00,287,1535,1822,35,4.277
2017-04-04 15:00:00+00:00,192,1680,1872,37,3.378
2017-04-04 16:00:00+00:00,97,1972,2069,42,2.271
2017-04-04 17:00:00+00:00,22,2128,2150,46,1.235
2017-04-04 18:00:00+00:00,1,2188,2189,46,0.635
2017-04-04 19:00:00+00:00,0,2128,2128,41,0.245
2017-04-04 20:00:00+00:00,0,1845,1845,38,-0.095
2017-04-04 21:00:00+00:00,0,1701,1701,33,-0.37
2017-04-04 22:00:00+00:00,0,1800,1800,33,-0.541
2017-04-04 23:00:00+00:00,0,1785,1785,30,-0.589
2017-04-05 00:00:00+00:00,0,1610,1610,29,-0.51
2017-04-05 01:00:00+00:00,0,1454,1454,29,-0.56
2017-04-05 02:00:00+00:00,0,1313,1313,30,-0.654
2017-04-05 03:00:00+00:00,0,1297,1297,31,-0.763
2017-04-05 04:00:00+00:00,1,1475,1476,39,-0.924
2017-04-05 05:00:00+00:00,30,1367,1397,46,-0.243
2017-04-05 06:00:00+00:00,89,1226,1315,48,0.992
2017-04-05 07:00:00+00:00,166,1188,1354,44,2.487
2017-04-05 08:00:00+00:00,257,1186,1443,39,4.089
2017-04-05 09:00:00+00:00,326,1339,1665,37,5.615
2017-04-05 10:00:00+00:00,368,1332,1700,32,6.76
2017-04-05 11:00:00+00:00,395,1221,1616,30,7.464
2017-04-05 12:00:00+00:00,389,1304,1693,29,7.997
2017-04-05 13:00:00+00:00,343,1612,1955,28,7.802
2017-04-05 14:00:00+00:00,269,1621,1890,26,7.129
2017-04-05 15:00:00+00:00,187,1427,1614,28,6.039
2017-04-05 16:00:00+00:00,103,1328,1431,31,4.568
2017-04-05 17:00:00+00:00,26,1177,1203,34,2.423
2017-04-05 18:00:00+00:00,1,1173,1174,33,1.508
2017-04-05 19:00:00+00:00,0,1169,1169,28,1.133
2017-04-05 20:00:00+00:00,0,1203,1203,26,0.804
2017-04-05 21:00:00+00:00,0,1309,1309,18,0.674
2017-04-05 22:00:00+00:00,0,928,928,14,0.601
2017-04-05 23:00:00+00:00,0,961,961,13,0.528
2017-04-06 00:00:00+00:00,0,1311,1311,14,0.125
2017-04-06 01:00:00+00:00,0,1889,1889,15,-0.295
2017-04-06 02:00:00+00:00,0,2105,2105,17,-0.442
2017-04-06 03:00:00+00:00,0,1623,1623,26,-0.798
2017-04-06 04:00:00+00:00,1,1492,1493,32,-0.977
2017-04-06 05:00:00+00:00,39,1669,1708,39,-0.562
2017-04-06 06:00:00+00:00,124,2201,2325,41,-0.06
2017-04-06 07:00:00+00:00,240,2402,2642,37,0.78
2017-04-06 08:00:00+00:00,341,2461,2802,34,1.784
2017-04-06 09:00:00+00:00,417,2502,2919,33,2.565
2017-04-06 10:00:00+00:00,457,2509,2966,31,2.975
2017-04-06 11:00:00+00:00,463,2531,2994,30,3.193
2017-04-06 12:00:00+00:00,458,2541,2999,29,3.203
2017-04-06 13:00:00+00:00,416,2561,2977,29,2.981
2017-04-06 14:00:00+00:00,333,2563,2896,30,2.471
2017-04-06 15:00:00+00:00,233,2498,2731,33,1.676
2017-04-06 16:00:00+00:00,124,2234,2358,35,0.455
2017-04-06 17:00:00+00:00,32,2063,2095,41,-1.673
2017-04-06 18:00:00+00:00,2,1871,1873,41,-2.956
2017-04-06 19:00:00+00:00,0,1857,1857,35,-2.964
2017-04-06 20:00:00+00:00,0,1798,1798,33,-2.924
2017-04-06 21:00:00+00:00,0,1751,1751,27,-3.052
2017-04-06 22:00:00+00:00,0,1719,1719,23,-3.043
2017-04-06 23:00:00+00:00,0,1637,1637,22,-3.163
2017-04-07 00:00:00+00:00,0,1501,1501,19,-3.063
2017-04-07 01:00:00+00:00,0,1583,1583,20,-3.067
2017-04-07 02:00:00+00:00,0,1439,1439,24,-3.241
2017-04-07 03:00:00+00:00,0,1213,1213,26,-3.429
2017-04-07 04:00:00+00:00,1,1436,1437,34,-3.438
2017-04-07 05:00:00+00:00,38,1572,1610,40,-2.111
2017-04-07 06:00:00+00:00,108,1740,1848,41,-0.367
2017-04-07 07:00:00+00:00,196,2021,2217,39,1.26
2017-04-07 08:00:00+00:00,275,2230,2505,39,2.783
2017-04-07 09:00:00+00:00,340,2137,2477,36,3.835
2017-04-07 10:00:00+00:00,383,1928,2311,33,4.439
2017-04-07 11:00:00+00:00,393,1722,2115,31,4.809
2017-04-07 12:00:00+00:00,375,1686,2061,29,4.748
2017-04-07 13:00:00+00:00,330,1707,2037,29,4.448
2017-04-07 14:00:00+00:00,266,1955,2221,29,4.04
2017-04-07 15:00:00+00:00,184,1984,2168,32,3.431
2017-04-07 16:00:00+00:00,95,1738,1833,37,2.584
2017-04-07 17:00:00+00:00,23,1650,1673,40,1.241
2017-04-07 18:00:00+00:00,2,1569,1571,40,0.716
2017-04-07 19:00:00+00:00,0,1291,1291,38,0.753
2017-04-07 20:00:00+00:00,0,1358,1358,36,0.737
2017-04-07 21:00:00+00:00,0,1409,1409,31,0.583
2017-04-07 22:00:00+00:00,0,1282,1282,31,0.459
2017-04-07 23:00:00+00:00,0,1369,1369,30,0.231
2017-04-08 00:00:00+00:00,0,1522,1522,30,-0.035
2017-04-08 01:00:00+00:00,0,1603,1603,31,-0.318
2017-04-08 02:00:00+00:00,0,1634,1634,31,-0.528
2017-04-08 03:00:00+00:00,0,1712,1712,32,-0.725
2017-04-08 04:00:00+00:00,2,1873,1875,34,-0.927
2017-04-08 05:00:00+00:00,51,1944,1995,35,0.617
2017-04-08 06:00:00+00:00,150,1925,2075,37,3.177
2017-04-08 07:00:00+00:00,273,1773,2046,39,5.148
2017-04-08 08:00:00+00:00,384,1677,2061,35,7.165
2017-04-08 09:00:00+00:00,468,1727,2195,34,8.936
2017-04-08 10:00:00+00:00,514,1680,2194,31,10.193
2017-04-08 11:00:00+00:00,520,1498,2018,29,10.996
2017-04-08 12:00:00+00:00,480,1227,1707,27,11.366
2017-04-08 13:00:00+00:00,413,1176,1589,28,11.383
2017-04-08 14:00:00+00:00,342,854,1196,27,11.004
2017-04-08 15:00:00+00:00,245,572,817,32,10.259
2017-04-08 16:00:00+00:00,126,463,589,37,8.917
2017-04-08 17:00:00+00:00,31,430,461,41,6.684
2017-04-08 18:00:00+00:00,2,467,469,42,5.92
2017-04-08 19:00:00+00:00,0,500,500,39,5.451
2017-04-08 20:00:00+00:00,0,425,425,39,4.777
2017-04-08 21:00:00+00:00,0,318,318,35,4.019
2017-04-08 22:00:00+00:00,0,227,227,33,3.282
2017-04-08 23:00:00+00:00,0,113,113,29,2.651
2017-04-09 00:00:00+00:00,0,56,56,27,2.183
2017-04-09 01:00:00+00:00,0,35,35,27,1.916
2017-04-09 02:00:00+00:00,0,17,17,28,1.84
2017-04-09 03:00:00+00:00,0,10,10,28,1.842
2017-04-09 04:00:00+00:00,3,11,14,28,1.765
2017-04-09 05:00:00+00:00,60,13,73,28,2.678
2017-04-09 06:00:00+00:00,174,10,184,27,4.893
2017-04-09 07:00:00+00:00,320,4,324,28,7.595
2017-04-09 08:00:00+00:00,455,3,458,22,10.203
2017-04-09 09:00:00+00:00,556,2,558,23,11.825
2017-04-09 10:00:00+00:00,616,4,620,19,12.874
2017-04-09 11:00:00+00:00,628,6,634,14,13.524
2017-04-09 12:00:00+00:00,596,10,606,11,13.75
2017-04-09 13:00:00+00:00,520,16,536,11,13.545
2017-04-09 14:00:00+00:00,407,20,427,16,12.869
2017-04-09 15:00:00+00:00,268,24,292,25,11.817
2017-04-09 16:00:00+00:00,133,41,174,32,10.329
2017-04-09 17:00:00+00:00,32,105,137,38,8.197
2017-04-09 18:00:00+00:00,2,188,190,40,7.488
2017-04-09 19:00:00+00:00,0,291,291,37,7.001
2017-04-09 20:00:00+00:00,0,342,342,36,6.37
2017-04-09 21:00:00+00:00,0,324,324,29,5.63
2017-04-09 22:00:00+00:00,0,293,293,27,4.812
2017-04-09 23:00:00+00:00,0,233,233,23,4.022
2017-04-10 00:00:00+00:00,0,223,223,20,3.257
2017-04-10 01:00:00+00:00,0,184,184,19,2.577
2017-04-10 02:00:00+00:00,0,177,177,20,2.035
2017-04-10 03:00:00+00:00,0,215,215,28,1.445
2017-04-10 04:00:00+00:00,4,267,271,36,0.997
2017-04-10 05:00:00+00:00,62,289,351,42,2.43
2017-04-10 06:00:00+00:00,178,183,361,40,6.123
2017-04-10 07:00:00+00:00,322,107,429,37,9.105
2017-04-10 08:00:00+00:00,454,127,581,35,11.2
2017-04-10 09:00:00+00:00,554,129,683,35,12.455
2017-04-10 10:00:00+00:00,609,96,705,30,13.227
2017-04-10 11:00:00+00:00,617,88,705,29,13.448
2017-04-10 12:00:00+00:00,581,97,678,27,13.413
2017-04-10 13:00:00+00:00,501,103,604,28,13.052
2017-04-10 14:00:00+00:00,387,115,502,28,12.349
2017-04-10 15:00:00+00:00,254,138,392,31,11.464
2017-04-10 16:00:00+00:00,126,166,292,34,10.004
2017-04-10 17:00:00+00:00,30,312,342,36,8.338
2017-04-10 18:00:00+00:00,2,481,483,39,7.26
2017-04-10 19:00:00+00:00,0,535,535,37,6.395
2017-04-10 20:00:00+00:00,0,517,517,34,5.889
2017-04-10 21:00:00+00:00,0,559,559,29,5.455
2017-04-10 22:00:00+00:00,0,477,477,24,5.169
2017-04-10 23:00:00+00:00,0,633,633,22,4.797
2017-04-11 00:00:00+00:00,0,661,661,20,4.475
2017-04-11 01:00:00+00:00,0,1039,1039,19,3.999
2017-04-11 02:00:00+00:00,0,1744,1744,21,3.548
2017-04-11 03:00:00+00:00,0,1844,1844,26,3.125
2017-04-11 04:00:00+00:00,1,2046,2047,35,2.935
2017-04-11 05:00:00+00:00,42,2069,2111,41,3.331
2017-04-11 06:00:00+00:00,117,1974,2091,41,3.416
2017-04-11 07:00:00+00:00,198,2041,2239,38,3.837
2017-04-11 08:00:00+00:00,284,2082,2366,34,5.093
2017-04-11 09:00:00+00:00,374,2227,2601,32,6.413
2017-04-11 10:00:00+00:00,441,2203,2644,30,7.178
2017-04-11 11:00:00+00:00,451,2076,2527,28,7.482
2017-04-11 12:00:00+00:00,416,2108,2524,28,7.283
2017-04-11 13:00:00+00:00,350,1997,2347,29,6.588
2017-04-11 14:00:00+00:00,275,1842,2117,30,5.925
2017-04-11 15:00:00+00:00,196,1758,1954,33,5.468
2017-04-11 16:00:00+00:00,104,1525,1629,39,4.571
2017-04-11 17:00:00+00:00,26,1216,1242,44,1.648
2017-04-11 18:00:00+00:00,3,882,885,45,0.102
2017-04-11 19:00:00+00:00,0,646,646,41,0.026
2017-04-11 20:00:00+00:00,0,373,373,37,-0.098
2017-04-11 21:00:00+00:00,0,181,181,30,-0.358
2017-04-11 22:00:00+00:00,0,86,86,27,-0.568
2017-04-11 23:00:00+00:00,0,56,56,23,-0.759
2017-04-12 00:00:00+00:00,0,50,50,23,-0.894
2017-04-12 01:00:00+00:00,0,44,44,23,-0.957
2017-04-12 02:00:00+00:00,0,53,53,23,-1.018
2017-04-12 03:00:00+00:00,0,83,83,27,-1.089
2017-04-12 04:00:00+00:00,5,170,175,34,-1.127
2017-04-12 05:00:00+00:00,60,273,333,38,0.383
2017-04-12 06:00:00+00:00,162,260,422,38,3.021
2017-04-12 07:00:00+00:00,286,300,586,36,5.51
2017-04-12 08:00:00+00:00,398,234,632,31,7.58
2017-04-12 09:00:00+00:00,479,172,651,32,9.026
2017-04-12 10:00:00+00:00,517,133,650,26,10.048
2017-04-12 11:00:00+00:00,516,90,606,25,10.75
2017-04-12 12:00:00+00:00,486,120,606,24,11.057
2017-04-12 13:00:00+00:00,423,146,569,25,11.008
2017-04-12 14:00:00+00:00,334,178,512,25,10.619
2017-04-12 15:00:00+00:00,226,274,500,28,9.978
2017-04-12 16:00:00+00:00,119,372,491,31,8.858
2017-04-12 17:00:00+00:00,32,482,514,34,6.904
2017-04-12 18:00:00+00:00,3,646,649,36,5.873
2017-04-12 19:00:00+00:00,0,610,610,33,4.889
2017-04-12 20:00:00+00:00,0,407,407,30,4.004
2017-04-12 21:00:00+00:00,0,281,281,24,3.405
2017-04-12 22:00:00+00:00,0,179,179,22,3.137
2017-04-12 23:00:00+00:00,0,153,153,20,2.559
2017-04-13 00:00:00+00:00,0,220,220,18,1.844
2017-04-13 01:00:00+00:00,0,447,447,19,1.045
2017-04-13 02:00:00+00:00,0,542,542,21,0.933
2017-04-13 03:00:00+00:00,0,502,502,25,0.93
2017-04-13 04:00:00+00:00,4,630,634,33,0.993
2017-04-13 05:00:00+00:00,54,907,961,37,2.932
2017-04-13 06:00:00+00:00,137,1182,1319,38,5.191
2017-04-13 07:00:00+00:00,235,1001,1236,35,6.376
2017-04-13 08:00:00+00:00,327,723,1050,31,7.308
2017-04-13 09:00:00+00:00,400,722,1122,30,8.139
2017-04-13 10:00:00+00:00,447,562,1009,26,9.019
2017-04-13 11:00:00+00:00,463,727,1190,25,9.528
2017-04-13 12:00:00+00:00,450,1056,1506,25,9.624
2017-04-13 13:00:00+00:00,397,1676,2073,26,9.411
2017-04-13 14:00:00+00:00,325,1847,2172,25,8.811
2017-04-13 15:00:00+00:00,223,1294,1517,29,7.821
2017-04-13 16:00:00+00:00,114,786,900,34,6.426
2017-04-13 17:00:00+00:00,32,587,619,38,4.308
2017-04-13 18:00:00+00:00,4,432,436,40,3.172
2017-04-13 19:00:00+00:00,0,348,348,38,3.076
2017-04-13 20:00:00+00:00,0,398,398,36,2.899
2017-04-13 21:00:00+00:00,0,454,454,31,2.688
2017-04-13 22:00:00+00:00,0,432,432,27,2.352
2017-04-13 23:00:00+00:00,0,410,410,26,2.149
2017-04-14 00:00:00+00:00,0,490,490,26,1.958
2017-04-14 01:00:00+00:00,0,307,307,24,1.813
2017-04-14 02:00:00+00:00,0,233,233,24,1.604
2017-04-14 03:00:00+00:00,0,349,349,27,1.437
2017-04-14 04:00:00+00:00,6,493,499,29,1.375
2017-04-14 05:00:00+00:00,64,324,388,32,2.523
2017-04-14 06:00:00+00:00,163,232,395,31,3.841
2017-04-14 07:00:00+00:00,280,234,514,31,5.631
2017-04-14 08:00:00+00:00,389,228,617,30,7.61
2017-04-14 09:00:00+00:00,475,274,749,29,9.124
2017-04-14 10:00:00+00:00,530,322,852,27,9.987
2017-04-14 11:00:00+00:00,536,310,846,26,10.297
2017-04-14 12:00:00+00:00,504,308,812,25,10.407
2017-04-14 13:00:00+00:00,435,233,668,25,10.048
2017-04-14 14:00:00+00:00,337,217,554,25,9.145
2017-04-14 15:00:00+00:00,231,168,399,28,7.836
2017-04-14 16:00:00+00:00,127,105,232,35,6.316
2017-04-14 17:00:00+00:00,37,41,78,38,4.778
2017-04-14 18:00:00+00:00,3,24,27,41,3.831
2017-04-14 19:00:00+00:00,0,23,23,39,3.545
2017-04-14 20:00:00+00:00,0,28,28,36,3.28
2017-04-14 21:00:00+00:00,0,44,44,32,2.896
2017-04-14 22:00:00+00:00,0,53,53,27,2.522
2017-04-14 23:00:00+00:00,0,46,46,23,2.278
2017-04-15 00:00:00+00:00,0,43,43,21,1.96
2017-04-15 01:00:00+00:00,0,62,62,20,1.584
2017-04-15 02:00:00+00:00,0,83,83,19,1.204
2017-04-15 03:00:00+00:00,0,65,65,17,1.03
2017-04-15 04:00:00+00:00,5,74,79,17,0.962
2017-04-15 05:00:00+00:00,57,97,154,20,2.3
2017-04-15 06:00:00+00:00,140,155,295,25,4.029
2017-04-15 07:00:00+00:00,240,186,426,25,5.632
2017-04-15 08:00:00+00:00,332,174,506,23,7.441
2017-04-15 09:00:00+00:00,395,178,573,19,8.474
2017-04-15 10:00:00+00:00,432,158,590,12,8.722
2017-04-15 11:00:00+00:00,436,209,645,10,8.27
2017-04-15 12:00:00+00:00,403,299,702,7,7.483
2017-04-15 13:00:00+00:00,340,532,872,7,6.633
2017-04-15 14:00:00+00:00,262,532,794,8,5.925
2017-04-15 15:00:00+00:00,178,352,530,14,5.407
2017-04-15 16:00:00+00:00,103,369,472,20,4.905
2017-04-15 17:00:00+00:00,32,589,621,28,3.541
2017-04-15 18:00:00+00:00,3,598,601,28,2.507
2017-04-15 19:00:00+00:00,0,644,644,25,2.143
2017-04-15 20:00:00+00:00,0,841,841,21,1.773
2017-04-15 21:00:00+00:00,0,908,908,17,1.631
2017-04-15 22:00:00+00:00,0,752,752,10,1.259
2017-04-15 23:00:00+00:00,0,969,969,4,0.665
2017-04-16 00:00:00+00:00,0,1510,1510,3,0.191
2017-04-16 01:00:00+00:00,0,1663,1663,5,-0.148
2017-04-16 02:00:00+00:00,0,1389,1389,5,-0.329
2017-04-16 03:00:00+00:00,0,873,873,3,-0.42
2017-04-16 04:00:00+00:00,5,743,748,1,-0.468
2017-04-16 05:00:00+00:00,56,697,753,5,0.218
2017-04-16 06:00:00+00:00,142,866,1008,9,0.653
2017-04-16 07:00:00+00:00,226,1140,1366,11,1.636
2017-04-16 08:00:00+00:00,298,1254,1552,8,2.972
2017-04-16 09:00:00+00:00,367,1322,1689,2,3.865
2017-04-16 10:00:00+00:00,419,1224,1643,-3,4.375
2017-04-16 11:00:00+00:00,437,1182,1619,-12,4.82
2017-04-16 12:00:00+00:00,408,1197,1605,-14,4.76
2017-04-16 13:00:00+00:00,345,1535,1880,-9,3.982
2017-04-16 14:00:00+00:00,257,1701,1958,-6,2.375
2017-04-16 15:00:00+00:00,168,1369,1537,11,1.148
2017-04-16 16:00:00+00:00,95,927,1022,17,0.424
2017-04-16 17:00:00+00:00,31,1029,1060,28,-0.334
2017-04-16 18:00:00+00:00,4,1010,1014,35,-1.064
2017-04-16 19:00:00+00:00,0,1081,1081,33,-1.736
2017-04-16 20:00:00+00:00,0,998,998,35,-2.259
2017-04-16 21:00:00+00:00,0,887,887,30,-2.497
2017-04-16 22:00:00+00:00,0,752,752,25,-2.627
2017-04-16 23:00:00+00:00,0,632,632,22,-2.683
2017-04-17 00:00:00+00:00,0,610,610,20,-3.006
2017-04-17 01:00:00+00:00,0,696,696,19,-3.291
2017-04-17 02:00:00+00:00,0,611,611,18,-3.341
2017-04-17 03:00:00+00:00,0,590,590,18,-3.339
2017-04-17 04:00:00+00:00,6,585,591,20,-3.159
2017-04-17 05:00:00+00:00,53,547,600,19,-1.864
2017-04-17 06:00:00+00:00,132,566,698,14,-0.598
2017-04-17 07:00:00+00:00,227,538,765,15,0.637
2017-04-17 08:00:00+00:00,311,342,653,14,1.678
2017-04-17 09:00:00+00:00,367,220,587,16,2.579
2017-04-17 10:00:00+00:00,391,320,711,12,3.673
2017-04-17 11:00:00+00:00,391,484,875,12,4.015
2017-04-17 12:00:00+00:00,362,209,571,8,3.436
2017-04-17 13:00:00+00:00,314,290,604,8,2.789
2017-04-17 14:00:00+00:00,245,276,521,8,2.368
2017-04-17 15:00:00+00:00,181,177,358,12,1.826
2017-04-17 16:00:00+00:00,110,105,215,20,1.184
2017-04-17 17:00:00+00:00,34,207,241,24,0.006
2017-04-17 18:00:00+00:00,4,254,258,28,-1.16
2017-04-17 19:00:00+00:00,0,256,256,28,-1.671
2017-04-17 20:00:00+00:00,0,238,238,28,-1.847
2017-04-17 21:00:00+00:00,0,334,334,23,-2.404
2017-04-17 22:00:00+00:00,0,823,823,20,-3.427
2017-04-17 23:00:00+00:00,0,1449,1449,19,-4.034
2017-04-18 00:00:00+00:00,0,1485,1485,18,-4.179
2017-04-18 01:00:00+00:00,0,1356,1356,17,-4.477
2017-04-18 02:00:00+00:00,0,1519,1519,18,-4.553
2017-04-18 03:00:00+00:00,0,1545,1545,24,-4.443
2017-04-18 04:00:00+00:00,6,1206,1212,35,-4.221
2017-04-18 05:00:00+00:00,60,902,962,47,-3.189
2017-04-18 06:00:00+00:00,146,1131,1277,47,-2.216
2017-04-18 07:00:00+00:00,223,1221,1444,47,-1.548
2017-04-18 08:00:00+00:00,270,1201,1471,38,-1.084
2017-04-18 09:00:00+00:00,344,1062,1406,39,-1.144
2017-04-18 10:00:00+00:00,394,1253,1647,35,-1.383
2017-04-18 11:00:00+00:00,416,1125,1541,35,-1.501
2017-04-18 12:00:00+00:00,397,910,1307,35,-1.385
2017-04-18 13:00:00+00:00,355,1020,1375,32,-1.481
2017-04-18 14:00:00+00:00,293,1207,1500,29,-1.924
2017-04-18 15:00:00+00:00,201,1279,1480,34,-2.477
2017-04-18 16:00:00+00:00,114,848,962,39,-3.149
2017-04-18 17:00:00+00:00,40,818,858,40,-3.921
2017-04-18 18:00:00+00:00,6,957,963,46,-4.738
2017-04-18 19:00:00+00:00,0,1302,1302,41,-4.86
2017-04-18 20:00:00+00:00,0,1736,1736,40,-4.749
2017-04-18 21:00:00+00:00,0,1891,1891,32,-4.627
2017-04-18 22:00:00+00:00,0,1963,1963,33,-4.632
2017-04-18 23:00:00+00:00,0,2364,2364,30,-4.896
2017-04-19 00:00:00+00:00,0,2472,2472,30,-5.2
2017-04-19 01:00:00+00:00,0,2494,2494,29,-5.518
2017-04-19 02:00:00+00:00,0,2533,2533,29,-5.877
2017-04-19 03:00:00+00:00,0,2527,2527,32,-6.121
2017-04-19 04:00:00+00:00,6,2464,2470,40,-6.282
2017-04-19 05:00:00+00:00,53,2433,2486,45,-5.952
2017-04-19 06:00:00+00:00,129,2492,2621,44,-5.56
2017-04-19 07:00:00+00:00,213,2545,2758,43,-5.106
2017-04-19 08:00:00+00:00,281,2508,2789,39,-4.606
2017-04-19 09:00:00+00:00,324,2508,2832,37,-4.233
2017-04-19 10:00:00+00:00,364,2379,2743,35,-3.932
2017-04-19 11:00:00+00:00,391,2369,2760,35,-3.738
2017-04-19 12:00:00+00:00,380,2396,2776,34,-3.822
2017-04-19 13:00:00+00:00,329,2342,2671,35,-4.081
2017-04-19 14:00:00+00:00,267,2205,2472,33,-4.489
2017-04-19 15:00:00+00:00,191,2183,2374,37,-5.031
2017-04-19 16:00:00+00:00,109,2257,2366,40,-5.59
2017-04-19 17:00:00+00:00,35,2282,2317,43,-6.109
2017-04-19 18:00:00+00:00,5,2342,2347,44,-6.311
2017-04-19 19:00:00+00:00,0,2410,2410,41,-6.439
2017-04-19 20:00:00+00:00,0,2403,2403,39,-6.512
2017-04-19 21:00:00+00:00,0,2392,2392,36,-6.736
2017-04-19 22:00:00+00:00,0,2393,2393,34,-6.818
2017-04-19 23:00:00+00:00,0,2375,2375,33,-6.944
2017-04-20 00:00:00+00:00,0,2365,2365,33,-7.046
2017-04-20 01:00:00+00:00,0,2361,2361,32,-7.234
2017-04-20 02:00:00+00:00,0,2370,2370,33,-7.403
2017-04-20 03:00:00+00:00,0,2347,2347,36,-7.626
2017-04-20 04:00:00+00:00,8,2332,2340,43,-7.752
2017-04-20 05:00:00+00:00,65,2380,2445,50,-7.322
2017-04-20 06:00:00+00:00,155,2397,2552,50,-6.584
2017-04-20 07:00:00+00:00,255,2422,2677,45,-5.724
2017-04-20 08:00:00+00:00,334,2423,2757,40,-4.817
2017-04-20 09:00:00+00:00,385,2453,2838,39,-4.068
2017-04-20 10:00:00+00:00,400,2443,2843,38,-3.455
2017-04-20 11:00:00+00:00,384,2440,2824,36,-3.09
2017-04-20 12:00:00+00:00,361,2438,2799,34,-2.854
2017-04-20 13:00:00+00:00,319,2413,2732,34,-2.903
2017-04-20 14:00:00+00:00,260,2413,2673,35,-3.24
2017-04-20 15:00:00+00:00,184,2343,2527,38,-3.708
2017-04-20 16:00:00+00:00,103,2238,2341,41,-4.397
2017-04-20 17:00:00+00:00,35,2093,2128,46,-5.572
2017-04-20 18:00:00+00:00,6,1909,1915,46,-7.242
2017-04-20 19:00:00+00:00,0,1783,1783,42,-7.549
2017-04-20 20:00:00+00:00,0,1665,1665,38,-7.635
2017-04-20 21:00:00+00:00,0,1519,1519,33,-7.974
2017-04-20 22:00:00+00:00,0,1437,1437,32,-8.278
2017-04-20 23:00:00+00:00,0,1380,1380,30,-8.645
2017-04-21 00:00:00+00:00,0,1306,1306,28,-8.943
2017-04-21 01:00:00+00:00,0,1220,1220,28,-9.35
2017-04-21 02:00:00+00:00,0,1077,1077,29,-9.866
2017-04-21 03:00:00+00:00,0,890,890,32,-10.293
2017-04-21 04:00:00+00:00,13,888,901,36,-10.53
2017-04-21 05:00:00+00:00,90,865,955,41,-8.535
2017-04-21 06:00:00+00:00,218,785,1003,42,-5.029
2017-04-21 07:00:00+00:00,366,1192,1558,38,-2.916
2017-04-21 08:00:00+00:00,497,1611,2108,36,-1.386
2017-04-21 09:00:00+00:00,592,1503,2095,32,-0.23
2017-04-21 10:00:00+00:00,634,1378,2012,30,0.597
2017-04-21 11:00:00+00:00,627,1494,2121,27,1.129
2017-04-21 12:00:00+00:00,578,1622,2200,25,1.526
2017-04-21 13:00:00+00:00,489,1513,2002,25,1.786
2017-04-21 14:00:00+00:00,377,1590,1967,24,1.727
2017-04-21 15:00:00+00:00,255,1752,2007,27,1.376
2017-04-21 16:00:00+00:00,140,1458,1598,31,0.686
2017-04-21 17:00:00+00:00,45,1214,1259,34,-1.16
2017-04-21 18:00:00+00:00,6,1131,1137,32,-3.131
2017-04-21 19:00:00+00:00,0,1436,1436,29,-3.595
2017-04-21 20:00:00+00:00,0,1656,1656,26,-3.896
2017-04-21 21:00:00+00:00,0,1817,1817,20,-4.252
2017-04-21 22:00:00+00:00,0,2009,2009,11,-4.412
2017-04-21 23:00:00+00:00,0,1872,1872,11,-4.678
2017-04-22 00:00:00+00:00,0,1724,1724,10,-4.825
2017-04-22 01:00:00+00:00,0,1754,1754,11,-5.023
2017-04-22 02:00:00+00:00,0,1648,1648,9,-5.232
2017-04-22 03:00:00+00:00,0,1631,1631,11,-5.416
2017-04-22 04:00:00+00:00,13,1859,1872,11,-5.183
2017-04-22 05:00:00+00:00,80,1968,2048,16,-2.174
2017-04-22 06:00:00+00:00,181,1925,2106,16,0.741
2017-04-22 07:00:00+00:00,287,1737,2024,16,2.468
2017-04-22 08:00:00+00:00,378,1805,2183,15,3.648
2017-04-22 09:00:00+00:00,451,1880,2331,10,4.624
2017-04-22 10:00:00+00:00,496,2003,2499,9,5.61
2017-04-22 11:00:00+00:00,506,2111,2617,4,6.263
2017-04-22 12:00:00+00:00,480,2137,2617,-2,6.474
2017-04-22 13:00:00+00:00,421,2144,2565,-2,6.233
2017-04-22 14:00:00+00:00,332,2192,2524,2,5.626
2017-04-22 15:00:00+00:00,189,2231,2420,11,4.638
2017-04-22 16:00:00+00:00,96,1841,1937,20,3.125
2017-04-22 17:00:00+00:00,35,1599,1634,21,1.202
2017-04-22 18:00:00+00:00,5,1218,1223,23,0.211
2017-04-22 19:00:00+00:00,0,966,966,22,-0.1
2017-04-22 20:00:00+00:00,0,951,951,24,-0.383
2017-04-22 21:00:00+00:00,0,1121,1121,17,-0.822
2017-04-22 22:00:00+00:00,0,1153,1153,15,-1.302
2017-04-22 23:00:00+00:00,0,1212,1212,12,-1.905
2017-04-23 00:00:00+00:00,0,1270,1270,11,-2.473
2017-04-23 01:00:00+00:00,0,1218,1218,8,-2.825
2017-04-23 02:00:00+00:00,0,1312,1312,10,-3.094
2017-04-23 03:00:00+00:00,0,1381,1381,11,-3.192
2017-04-23 04:00:00+00:00,13,1461,1474,10,-3.263
2017-04-23 05:00:00+00:00,83,1385,1468,12,-2.203
2017-04-23 06:00:00+00:00,197,1762,1959,10,-1.354
2017-04-23 07:00:00+00:00,316,2088,2404,9,-0.287
2017-04-23 08:00:00+00:00,413,2228,2641,7,0.844
2017-04-23 09:00:00+00:00,460,2307,2767,7,1.805
2017-04-23 10:00:00+00:00,515,2260,2775,0,2.685
2017-04-23 11:00:00+00:00,544,2002,2546,-13,3.377
2017-04-23 12:00:00+00:00,520,1778,2298,-14,3.927
2017-04-23 13:00:00+00:00,454,1566,2020,-13,4.085
2017-04-23 14:00:00+00:00,361,1175,1536,0,3.9
2017-04-23 15:00:00+00:00,252,711,963,11,3.242
2017-04-23 16:00:00+00:00,143,656,799,25,2.037
2017-04-23 17:00:00+00:00,49,467,516,34,0.048
2017-04-23 18:00:00+00:00,8,474,482,38,-1.782
2017-04-23 19:00:00+00:00,0,533,533,34,-1.985
2017-04-23 20:00:00+00:00,0,635,635,34,-2.054
2017-04-23 21:00:00+00:00,0,785,785,30,-2.165
2017-04-23 22:00:00+00:00,0,759,759,25,-2.272
2017-04-23 23:00:00+00:00,0,666,666,24,-2.463
2017-04-24 00:00:00+00:00,0,716,716,23,-2.75
2017-04-24 01:00:00+00:00,0,714,714,23,-3.06
2017-04-24 02:00:00+00:00,0,585,585,23,-3.475
2017-04-24 03:00:00+00:00,0,476,476,30,-3.859
2017-04-24 04:00:00+00:00,16,350,366,39,-3.641
2017-04-24 05:00:00+00:00,91,189,280,42,-1.187
2017-04-24 06:00:00+00:00,213,67,280,39,1.222
2017-04-24 07:00:00+00:00,352,47,399,35,3.619
2017-04-24 08:00:00+00:00,483,42,525,32,5.858
2017-04-24 09:00:00+00:00,584,102,686,30,7.603
2017-04-24 10:00:00+00:00,644,275,919,26,8.879
2017-04-24 11:00:00+00:00,661,433,1094,22,9.554
2017-04-24 12:00:00+00:00,629,463,1092,20,9.703
2017-04-24 13:00:00+00:00,554,461,1015,22,9.452
2017-04-24 14:00:00+00:00,443,550,993,22,8.81
2017-04-24 15:00:00+00:00,307,613,920,32,7.927
2017-04-24 16:00:00+00:00,170,647,817,36,6.653
2017-04-24 17:00:00+00:00,57,691,748,40,4.466
2017-04-24 18:00:00+00:00,9,984,993,40,2.651
2017-04-24 19:00:00+00:00,0,1215,1215,38,1.446
2017-04-24 20:00:00+00:00,0,1189,1189,32,0.792
2017-04-24 21:00:00+00:00,0,1030,1030,27,0.881
2017-04-24 22:00:00+00:00,0,854,854,33,1.037
2017-04-24 23:00:00+00:00,0,731,731,32,1.273
2017-04-25 00:00:00+00:00,0,595,595,30,1.364
2017-04-25 01:00:00+00:00,0,539,539,30,1.404
2017-04-25 02:00:00+00:00,0,516,516,30,1.427
2017-04-25 03:00:00+00:00,0,540,540,32,1.481
2017-04-25 04:00:00+00:00,16,607,623,37,1.831
2017-04-25 05:00:00+00:00,86,617,703,44,2.875
2017-04-25 06:00:00+00:00,194,478,672,47,4.153
2017-04-25 07:00:00+00:00,309,509,818,44,5.667
2017-04-25 08:00:00+00:00,412,568,980,40,7.461
2017-04-25 09:00:00+00:00,489,640,1129,38,9.117
2017-04-25 10:00:00+00:00,546,735,1281,35,10.155
2017-04-25 11:00:00+00:00,558,850,1408,34,10.468
2017-04-25 12:00:00+00:00,530,862,1392,33,10.314
2017-04-25 13:00:00+00:00,473,924,1397,33,9.716
2017-04-25 14:00:00+00:00,379,1077,1456,34,8.996
2017-04-25 15:00:00+00:00,262,1279,1541,38,8.053
2017-04-25 16:00:00+00:00,146,1223,1369,39,6.803
2017-04-25 17:00:00+00:00,50,1328,1378,43,5.039
2017-04-25 18:00:00+00:00,8,1544,1552,46,3.984
2017-04-25 19:00:00+00:00,0,1432,1432,44,3.565
2017-04-25 20:00:00+00:00,0,1647,1647,39,3.443
2017-04-25 21:00:00+00:00,0,964,964,33,3.376
2017-04-25 22:00:00+00:00,0,397,397,33,3.079
2017-04-25 23:00:00+00:00,0,213,213,32,2.69
2017-04-26 00:00:00+00:00,0,111,111,32,2.706
2017-04-26 01:00:00+00:00,0,104,104,32,2.836
2017-04-26 02:00:00+00:00,0,178,178,32,2.889
2017-04-26 03:00:00+00:00,0,343,343,34,2.63
2017-04-26 04:00:00+00:00,17,658,675,41,2.452
2017-04-26 05:00:00+00:00,85,898,983,50,2.932
2017-04-26 06:00:00+00:00,188,826,1014,54,3.562
2017-04-26 07:00:00+00:00,302,791,1093,51,4.619
2017-04-26 08:00:00+00:00,395,685,1080,48,6.379
2017-04-26 09:00:00+00:00,447,713,1160,47,7.408
2017-04-26 10:00:00+00:00,486,798,1284,42,8.274
2017-04-26 11:00:00+00:00,478,863,1341,40,8.735
2017-04-26 12:00:00+00:00,417,713,1130,40,8.691
2017-04-26 13:00:00+00:00,362,979,1341,39,8.271
2017-04-26 14:00:00+00:00,300,1307,1607,40,7.476
2017-04-26 15:00:00+00:00,217,1455,1672,43,6.213
2017-04-26 16:00:00+00:00,130,1192,1322,46,4.665
2017-04-26 17:00:00+00:00,47,924,971,48,3.168
2017-04-26 18:00:00+00:00,8,881,889,48,2.049
2017-04-26 19:00:00+00:00,0,798,798,46,1.703
2017-04-26 20:00:00+00:00,0,651,651,41,1.625
2017-04-26 21:00:00+00:00,0,562,562,36,1.697
2017-04-26 22:00:00+00:00,0,416,416,33,1.797
2017-04-26 23:00:00+00:00,0,408,408,32,2.057
2017-04-27 00:00:00+00:00,0,451,451,31,2.213
2017-04-27 01:00:00+00:00,0,392,392,31,2.093
2017-04-27 02:00:00+00:00,0,483,483,31,1.76
2017-04-27 03:00:00+00:00,0,707,707,33,1.476
2017-04-27 04:00:00+00:00,13,668,681,40,1.384
2017-04-27 05:00:00+00:00,65,692,757,47,1.943
2017-04-27 06:00:00+00:00,133,677,810,49,2.655
2017-04-27 07:00:00+00:00,208,662,870,45,3.413
2017-04-27 08:00:00+00:00,274,582,856,42,4.053
2017-04-27 09:00:00+00:00,319,714,1033,39,4.775
2017-04-27 10:00:00+00:00,334,663,997,35,5.583
2017-04-27 11:00:00+00:00,320,442,762,36,5.923
2017-04-27 12:00:00+00:00,310,307,617,33,5.679
2017-04-27 13:00:00+00:00,281,278,559,34,5.288
2017-04-27 14:00:00+00:00,219,341,560,34,4.659
2017-04-27 15:00:00+00:00,145,381,526,39,3.743
2017-04-27 16:00:00+00:00,78,329,407,43,2.8
2017-04-27 17:00:00+00:00,25,355,380,45,1.939
2017-04-27 18:00:00+00:00,4,322,326,44,1.266
2017-04-27 19:00:00+00:00,0,344,344,43,0.616
2017-04-27 20:00:00+00:00,0,449,449,40,0.079
2017-04-27 21:00:00+00:00,0,464,464,32,-0.225
2017-04-27 22:00:00+00:00,0,381,381,31,-0.289
2017-04-27 23:00:00+00:00,0,345,345,30,-0.439
2017-04-28 00:00:00+00:00,0,300,300,30,-0.898
2017-04-28 01:00:00+00:00,0,129,129,30,-1.486
2017-04-28 02:00:00+00:00,0,294,294,30,-1.845
2017-04-28 03:00:00+00:00,0,603,603,31,-2.035
2017-04-28 04:00:00+00:00,15,640,655,40,-1.914
2017-04-28 05:00:00+00:00,75,710,785,46,-1.085
2017-04-28 06:00:00+00:00,152,519,671,47,-0.317
2017-04-28 07:00:00+00:00,221,372,593,46,0.088
2017-04-28 08:00:00+00:00,270,397,667,45,0.435
2017-04-28 09:00:00+00:00,298,356,654,44,0.807
2017-04-28 10:00:00+00:00,316,439,755,41,1.249
2017-04-28 11:00:00+00:00,328,433,761,38,1.484
2017-04-28 12:00:00+00:00,329,435,764,36,1.466
2017-04-28 13:00:00+00:00,309,442,751,35,1.098
2017-04-28 14:00:00+00:00,265,527,792,34,0.305
2017-04-28 15:00:00+00:00,205,747,952,36,-0.569
2017-04-28 16:00:00+00:00,127,1158,1285,38,-1.489
2017-04-28 17:00:00+00:00,48,1239,1287,41,-2.324
2017-04-28 18:00:00+00:00,9,1453,1462,40,-3.475
2017-04-28 19:00:00+00:00,0,1668,1668,38,-4.313
2017-04-28 20:00:00+00:00,0,1672,1672,34,-4.619
2017-04-28 21:00:00+00:00,0,1798,1798,30,-4.84
2017-04-28 22:00:00+00:00,0,2036,2036,33,-5.149
2017-04-28 23:00:00+00:00,0,2060,2060,31,-5.285
2017-04-29 00:00:00+00:00,0,1943,1943,32,-5.429
2017-04-29 01:00:00+00:00,0,1703,1703,31,-5.532
2017-04-29 02:00:00+00:00,0,1432,1432,30,-5.666
2017-04-29 03:00:00+00:00,0,1188,1188,30,-5.719
2017-04-29 04:00:00+00:00,23,927,950,31,-5.461
2017-04-29 05:00:00+00:00,107,663,770,33,-3.59
2017-04-29 06:00:00+00:00,220,432,652,34,-1.376
2017-04-29 07:00:00+00:00,343,408,751,33,-0.173
2017-04-29 08:00:00+00:00,452,374,826,31,0.66
2017-04-29 09:00:00+00:00,523,428,951,29,1.391
2017-04-29 10:00:00+00:00,537,407,944,28,2.189
2017-04-29 11:00:00+00:00,539,322,861,27,3.132
2017-04-29 12:00:00+00:00,526,303,829,26,3.997
2017-04-29 13:00:00+00:00,478,294,772,26,4.59
2017-04-29 14:00:00+00:00,410,166,576,27,4.741
2017-04-29 15:00:00+00:00,298,218,516,30,4.408
2017-04-29 16:00:00+00:00,173,138,311,34,3.498
2017-04-29 17:00:00+00:00,66,83,149,39,1.689
2017-04-29 18:00:00+00:00,13,140,153,38,-0.231
2017-04-29 19:00:00+00:00,0,169,169,37,-1.085
2017-04-29 20:00:00+00:00,0,129,129,36,-1.906
2017-04-29 21:00:00+00:00,0,159,159,33,-2.418
2017-04-29 22:00:00+00:00,0,175,175,26,-2.713
2017-04-29 23:00:00+00:00,0,166,166,23,-2.879
2017-04-30 00:00:00+00:00,0,140,140,22,-2.922
2017-04-30 01:00:00+00:00,0,98,98,21,-2.933
2017-04-30 02:00:00+00:00,0,73,73,20,-2.901
2017-04-30 03:00:00+00:00,1,93,94,18,-3.026
2017-04-30 04:00:00+00:00,27,135,162,13,-2.477
2017-04-30 05:00:00+00:00,122,106,228,11,-0.171
2017-04-30 06:00:00+00:00,260,56,316,14,1.499
2017-04-30 07:00:00+00:00,408,43,451,10,3.397
2017-04-30 08:00:00+00:00,534,52,586,3,5.254
2017-04-30 09:00:00+00:00,621,98,719,3,6.944
2017-04-30 10:00:00+00:00,660,147,807,-6,8.309
2017-04-30 11:00:00+00:00,667,216,883,-31,9.285
2017-04-30 12:00:00+00:00,640,310,950,-26,9.785
2017-04-30 13:00:00+00:00,575,367,942,-43,9.753
2017-04-30 14:00:00+00:00,467,420,887,-20,9.205
2017-04-30 15:00:00+00:00,334,467,801,3,8.258
2017-04-30 16:00:00+00:00,198,576,774,12,6.769
2017-04-30 17:00:00+00:00,75,705,780,18,4.301
2017-04-30 18:00:00+00:00,14,910,924,18,1.281
2017-04-30 19:00:00+00:00,0,1129,1129,16,0.976
2017-04-30 20:00:00+00:00,0,1437,1437,11,1.064
2017-04-30 21:00:00+00:00,0,1664,1664,4,0.715
2017-04-30 22:00:00+00:00,0,1787,1787,6,0.219
2017-04-30 23:00:00+00:00,0,1900,1900,0,-0.474
2017-05-01 00:00:00+00:00,0,1966,1966,-3,-0.729
2017-05-01 01:00:00+00:00,0,1979,1979,0,-0.841
2017-05-01 02:00:00+00:00,0,1808,1808,2,-0.958
2017-05-01 03:00:00+00:00,1,1848,1849,5,-1.028
2017-05-01 04:00:00+00:00,26,1898,1924,6,-0.468
2017-05-01 05:00:00+00:00,112,1677,1789,10,1.235
2017-05-01 06:00:00+00:00,234,1586,1820,10,3.273
2017-05-01 07:00:00+00:00,364,1443,1807,11,5.409
2017-05-01 08:00:00+00:00,475,1336,1811,10,7.525
2017-05-01 09:00:00+00:00,553,1187,1740,11,9.227
2017-05-01 10:00:00+00:00,592,1332,1924,10,10.371
2017-05-01 11:00:00+00:00,603,1508,2111,7,10.712
2017-05-01 12:00:00+00:00,562,1488,2050,10,9.905
2017-05-01 13:00:00+00:00,488,1396,1884,12,7.993
2017-05-01 14:00:00+00:00,393,1218,1611,14,6.61
2017-05-01 15:00:00+00:00,281,1068,1349,18,5.568
2017-05-01 16:00:00+00:00,167,883,1050,30,4.297
2017-05-01 17:00:00+00:00,64,640,704,32,2.875
2017-05-01 18:00:00+00:00,12,725,737,32,1.532
2017-05-01 19:00:00+00:00,0,1089,1089,32,0.686
2017-05-01 20:00:00+00:00,0,1509,1509,32,0.303
2017-05-01 21:00:00+00:00,0,1297,1297,28,-0.087
2017-05-01 22:00:00+00:00,0,992,992,26,-0.461
2017-05-01 23:00:00+00:00,0,729,729,25,-0.877
2017-05-02 00:00:00+00:00,0,669,669,24,-1.487
2017-05-02 01:00:00+00:00,0,723,723,25,-2.041
2017-05-02 02:00:00+00:00,0,842,842,26,-2.569
2017-05-02 03:00:00+00:00,0,942,942,29,-2.949
2017-05-02 04:00:00+00:00,23,960,983,37,-2.497
2017-05-02 05:00:00+00:00,107,807,914,43,-0.369
2017-05-02 06:00:00+00:00,221,617,838,42,1.421
2017-05-02 07:00:00+00:00,349,642,991,42,3.305
2017-05-02 08:00:00+00:00,461,566,1027,42,5.157
2017-05-02 09:00:00+00:00,548,370,918,41,6.697
2017-05-02 10:00:00+00:00,593,214,807,38,8.066
2017-05-02 11:00:00+00:00,607,94,701,37,9.134
2017-05-02 12:00:00+00:00,573,49,622,35,9.736
2017-05-02 13:00:00+00:00,506,29,535,35,9.788
2017-05-02 14:00:00+00:00,421,30,451,34,9.325
2017-05-02 15:00:00+00:00,315,35,350,36,8.604
2017-05-02 16:00:00+00:00,189,44,233,39,7.722
2017-05-02 17:00:00+00:00,72,58,130,40,5.591
2017-05-02 18:00:00+00:00,14,75,89,40,2.992
2017-05-02 19:00:00+00:00,0,112,112,37,2.158
2017-05-02 20:00:00+00:00,0,134,134,34,1.349
2017-05-02 21:00:00+00:00,0,160,160,25,0.576
2017-05-02 22:00:00+00:00,0,160,160,26,0.188
2017-05-02 23:00:00+00:00,0,220,220,24,-0.271
2017-05-03 00:00:00+00:00,0,263,263,24,-0.709
2017-05-03 01:00:00+00:00,0,293,293,24,-0.727
2017-05-03 02:00:00+00:00,0,242,242,25,-0.524
2017-05-03 03:00:00+00:00,0,197,197,30,-0.657
2017-05-03 04:00:00+00:00,26,221,247,36,-0.139
2017-05-03 05:00:00+00:00,111,197,308,42,1.383
2017-05-03 06:00:00+00:00,221,95,316,45,2.93
2017-05-03 07:00:00+00:00,334,53,387,40,3.981
2017-05-03 08:00:00+00:00,425,37,462,38,4.755
2017-05-03 09:00:00+00:00,483,42,525,37,5.505
2017-05-03 10:00:00+00:00,498,28,526,34,6.548
2017-05-03 11:00:00+00:00,481,20,501,33,7.775
2017-05-03 12:00:00+00:00,439,11,450,32,8.799
2017-05-03 13:00:00+00:00,386,54,440,32,9.045
2017-05-03 14:00:00+00:00,317,336,653,32,8.751
2017-05-03 15:00:00+00:00,232,375,607,34,7.994
2017-05-03 16:00:00+00:00,142,242,384,36,7.008
2017-05-03 17:00:00+00:00,53,154,207,38,5.331
2017-05-03 18:00:00+00:00,9,107,116,38,3.519
2017-05-03 19:00:00+00:00,0,53,53,35,2.912
2017-05-03 20:00:00+00:00,0,37,37,32,2.452
2017-05-03 21:00:00+00:00,0,68,68,27,2.124
2017-05-03 22:00:00+00:00,0,83,83,27,1.749
2017-05-03 23:00:00+00:00,0,59,59,25,1.276
2017-05-04 00:00:00+00:00,0,36,36,23,0.76
2017-05-04 01:00:00+00:00,0,26,26,23,0.308
2017-05-04 02:00:00+00:00,0,18,18,23,-0.053
2017-05-04 03:00:00+00:00,0,28,28,27,-0.618
2017-05-04 04:00:00+00:00,26,21,47,34,-0.488
2017-05-04 05:00:00+00:00,111,11,122,38,1.334
2017-05-04 06:00:00+00:00,225,4,229,40,3.069
2017-05-04 07:00:00+00:00,346,3,349,37,5.482
2017-05-04 08:00:00+00:00,447,8,455,36,7.454
2017-05-04 09:00:00+00:00,517,20,537,35,8.252
2017-05-04 10:00:00+00:00,546,48,594,32,8.594
2017-05-04 11:00:00+00:00,529,100,629,32,8.435
2017-05-04 12:00:00+00:00,467,117,584,30,8.068
2017-05-04 13:00:00+00:00,394,166,560,30,7.809
2017-05-04 14:00:00+00:00,332,161,493,29,7.33
2017-05-04 15:00:00+00:00,244,187,431,33,6.583
2017-05-04 16:00:00+00:00,147,187,334,34,5.713
2017-05-04 17:00:00+00:00,60,149,209,38,4.618
2017-05-04 18:00:00+00:00,12,159,171,37,3.536
2017-05-04 19:00:00+00:00,0,378,378,35,2.896
2017-05-04 20:00:00+00:00,0,689,689,32,2.285
2017-05-04 21:00:00+00:00,0,747,747,28,2.021
2017-05-04 22:00:00+00:00,0,627,627,28,1.971
2017-05-04 23:00:00+00:00,0,419,419,28,1.748
2017-05-05 00:00:00+00:00,0,240,240,27,1.395
2017-05-05 01:00:00+00:00,0,181,181,27,0.704
2017-05-05 02:00:00+00:00,0,138,138,28,0.048
2017-05-05 03:00:00+00:00,1,196,197,30,0.082
2017-05-05 04:00:00+00:00,22,267,289,37,0.792
2017-05-05 05:00:00+00:00,84,383,467,44,1.961
2017-05-05 06:00:00+00:00,171,335,506,47,2.648
2017-05-05 07:00:00+00:00,256,266,522,46,3.718
2017-05-05 08:00:00+00:00,323,263,586,45,4.97
2017-05-05 09:00:00+00:00,373,294,667,44,6.141
2017-05-05 10:00:00+00:00,429,394,823,41,7.356
2017-05-05 11:00:00+00:00,458,304,762,37,8.34
2017-05-05 12:00:00+00:00,449,389,838,36,8.677
2017-05-05 13:00:00+00:00,409,435,844,36,8.695
2017-05-05 14:00:00+00:00,341,533,874,34,8.3
2017-05-05 15:00:00+00:00,257,651,908,36,7.802
2017-05-05 16:00:00+00:00,163,875,1038,39,7.176
2017-05-05 17:00:00+00:00,67,1145,1212,41,5.826
2017-05-05 18:00:00+00:00,13,1344,1357,42,4.167
2017-05-05 19:00:00+00:00,0,1406,1406,40,3.553
2017-05-05 20:00:00+00:00,0,1329,1329,38,2.947
2017-05-05 21:00:00+00:00,0,1316,1316,33,2.152
2017-05-05 22:00:00+00:00,0,1266,1266,34,1.364
2017-05-05 23:00:00+00:00,0,1168,1168,31,0.655
2017-05-06 00:00:00+00:00,0,1033,1033,30,0.062
2017-05-06 01:00:00+00:00,0,874,874,30,-0.259
2017-05-06 02:00:00+00:00,0,670,670,30,-0.291
2017-05-06 03:00:00+00:00,1,542,543,30,-0.184
2017-05-06 04:00:00+00:00,29,533,562,32,0.905
2017-05-06 05:00:00+00:00,117,364,481,33,3.39
2017-05-06 06:00:00+00:00,234,144,378,35,5.494
2017-05-06 07:00:00+00:00,366,84,450,34,7.922
2017-05-06 08:00:00+00:00,481,56,537,32,10.151
2017-05-06 09:00:00+00:00,560,34,594,31,11.947
2017-05-06 10:00:00+00:00,601,51,652,28,13.501
2017-05-06 11:00:00+00:00,598,75,673,26,13.427
2017-05-06 12:00:00+00:00,575,142,717,26,12.423
2017-05-06 13:00:00+00:00,509,284,793,28,12.138
2017-05-06 14:00:00+00:00,410,488,898,31,11.542
2017-05-06 15:00:00+00:00,295,508,803,32,10.884
2017-05-06 16:00:00+00:00,177,521,698,35,9.422
2017-05-06 17:00:00+00:00,71,463,534,38,7.667
2017-05-06 18:00:00+00:00,14,614,628,37,6.293
2017-05-06 19:00:00+00:00,0,742,742,37,5.438
2017-05-06 20:00:00+00:00,0,670,670,35,4.721
2017-05-06 21:00:00+00:00,0,536,536,32,4.039
2017-05-06 22:00:00+00:00,0,392,392,29,3.75
2017-05-06 23:00:00+00:00,0,375,375,27,4.017
2017-05-07 00:00:00+00:00,0,316,316,26,4.368
2017-05-07 01:00:00+00:00,0,340,340,25,4.232
2017-05-07 02:00:00+00:00,0,316,316,26,3.637
2017-05-07 03:00:00+00:00,0,217,217,25,3.068
2017-05-07 04:00:00+00:00,19,186,205,25,2.843
2017-05-07 05:00:00+00:00,84,200,284,26,3.163
2017-05-07 06:00:00+00:00,149,247,396,29,3.602
2017-05-07 07:00:00+00:00,232,454,686,31,4.23
2017-05-07 08:00:00+00:00,306,668,974,31,5.102
2017-05-07 09:00:00+00:00,382,801,1183,31,6.188
2017-05-07 10:00:00+00:00,442,917,1359,30,7.08
2017-05-07 11:00:00+00:00,466,988,1454,25,7.678
2017-05-07 12:00:00+00:00,472,1485,1957,22,8.255
2017-05-07 13:00:00+00:00,438,1558,1996,21,8.787
2017-05-07 14:00:00+00:00,347,1251,1598,22,8.875
2017-05-07 15:00:00+00:00,248,1281,1529,26,8.3
2017-05-07 16:00:00+00:00,152,1266,1418,29,7.23
2017-05-07 17:00:00+00:00,60,1096,1156,32,5.604
2017-05-07 18:00:00+00:00,12,975,987,34,3.876
2017-05-07 19:00:00+00:00,0,1225,1225,33,3.64
2017-05-07 20:00:00+00:00,0,1351,1351,33,3.359
2017-05-07 21:00:00+00:00,0,1287,1287,27,2.952
2017-05-07 22:00:00+00:00,0,994,994,26,2.499
2017-05-07 23:00:00+00:00,0,911,911,25,2.15
2017-05-08 00:00:00+00:00,0,755,755,22,1.911
2017-05-08 01:00:00+00:00,0,936,936,20,1.692
2017-05-08 02:00:00+00:00,0,1265,1265,21,1.616
2017-05-08 03:00:00+00:00,1,1317,1318,23,1.598
2017-05-08 04:00:00+00:00,28,1201,1229,31,1.936
2017-05-08 05:00:00+00:00,110,1041,1151,38,2.554
2017-05-08 06:00:00+00:00,203,997,1200,41,3.212
2017-05-08 07:00:00+00:00,302,1264,1566,36,4.086
2017-05-08 08:00:00+00:00,376,1308,1684,36,5.121
2017-05-08 09:00:00+00:00,412,1170,1582,37,6.111
2017-05-08 10:00:00+00:00,432,1070,1502,31,6.909
2017-05-08 11:00:00+00:00,424,1058,1482,30,7.329
2017-05-08 12:00:00+00:00,394,949,1343,29,7.377
2017-05-08 13:00:00+00:00,338,830,1168,28,7.128
2017-05-08 14:00:00+00:00,280,789,1069,28,6.625
2017-05-08 15:00:00+00:00,207,678,885,31,5.805
2017-05-08 16:00:00+00:00,127,686,813,34,4.617
2017-05-08 17:00:00+00:00,54,1339,1393,37,3.223
2017-05-08 18:00:00+00:00,13,1743,1756,37,1.893
2017-05-08 19:00:00+00:00,0,1867,1867,36,1.21
2017-05-08 20:00:00+00:00,0,1771,1771,33,0.979
2017-05-08 21:00:00+00:00,0,1469,1469,28,0.901
2017-05-08 22:00:00+00:00,0,1000,1000,31,0.827
2017-05-08 23:00:00+00:00,0,872,872,31,0.629
2017-05-09 00:00:00+00:00,0,815,815,30,0.396
2017-05-09 01:00:00+00:00,0,653,653,31,0.215
2017-05-09 02:00:00+00:00,0,561,561,32,0.052
2017-05-09 03:00:00+00:00,1,500,501,35,-0.213
2017-05-09 04:00:00+00:00,23,600,623,44,-0.235
2017-05-09 05:00:00+00:00,90,777,867,49,0.271
2017-05-09 06:00:00+00:00,182,1050,1232,50,1.216
2017-05-09 07:00:00+00:00,277,1124,1401,48,2.599
2017-05-09 08:00:00+00:00,354,926,1280,44,3.992
2017-05-09 09:00:00+00:00,393,911,1304,41,5.137
2017-05-09 10:00:00+00:00,415,854,1269,39,6.034
2017-05-09 11:00:00+00:00,457,699,1156,38,6.538
2017-05-09 12:00:00+00:00,448,668,1116,35,6.732
2017-05-09 13:00:00+00:00,413,887,1300,35,6.679
2017-05-09 14:00:00+00:00,349,1234,1583,36,6.03
2017-05-09 15:00:00+00:00,265,1194,1459,39,4.952
2017-05-09 16:00:00+00:00,163,1138,1301,42,3.71
2017-05-09 17:00:00+00:00,66,936,1002,44,2.19
2017-05-09 18:00:00+00:00,15,786,801,44,0.217
2017-05-09 19:00:00+00:00,0,760,760,43,-0.521
2017-05-09 20:00:00+00:00,0,755,755,39,-0.796
2017-05-09 21:00:00+00:00,0,620,620,34,-1.086
2017-05-09 22:00:00+00:00,0,276,276,31,-1.417
2017-05-09 23:00:00+00:00,0,124,124,29,-1.67
2017-05-10 00:00:00+00:00,0,47,47,29,-1.907
2017-05-10 01:00:00+00:00,0,20,20,27,-2.12
2017-05-10 02:00:00+00:00,0,11,11,30,-2.45
2017-05-10 03:00:00+00:00,1,8,9,31,-2.849
2017-05-10 04:00:00+00:00,39,6,45,40,-1.879
2017-05-10 05:00:00+00:00,144,11,155,46,-0.015
2017-05-10 06:00:00+00:00,280,19,299,48,2.703
2017-05-10 07:00:00+00:00,420,79,499,43,5.227
2017-05-10 08:00:00+00:00,542,146,688,39,7.391
2017-05-10 09:00:00+00:00,629,196,825,38,9.144
2017-05-10 10:00:00+00:00,679,238,917,35,10.48
2017-05-10 11:00:00+00:00,683,271,954,34,11.436
2017-05-10 12:00:00+00:00,640,263,903,33,11.953
2017-05-10 13:00:00+00:00,565,284,849,33,11.941
2017-05-10 14:00:00+00:00,466,278,744,35,11.522
2017-05-10 15:00:00+00:00,345,336,681,40,10.697
2017-05-10 16:00:00+00:00,213,428,641,45,9.488
2017-05-10 17:00:00+00:00,90,539,629,49,7.563
2017-05-10 18:00:00+00:00,20,912,932,49,5.288
2017-05-10 19:00:00+00:00,1,1326,1327,47,4.67
2017-05-10 20:00:00+00:00,0,1440,1440,42,3.879
2017-05-10 21:00:00+00:00,0,1390,1390,36,3.136
2017-05-10 22:00:00+00:00,0,1282,1282,33,2.563
2017-05-10 23:00:00+00:00,0,983,983,31,2.153
2017-05-11 00:00:00+00:00,0,801,801,29,1.942
2017-05-11 01:00:00+00:00,0,474,474,30,1.756
2017-05-11 02:00:00+00:00,0,309,309,31,1.635
2017-05-11 03:00:00+00:00,2,208,210,33,1.549
2017-05-11 04:00:00+00:00,40,156,196,40,2.38
2017-05-11 05:00:00+00:00,143,79,222,45,4.192
2017-05-11 06:00:00+00:00,275,39,314,47,6.628
2017-05-11 07:00:00+00:00,406,32,438,44,9.246
2017-05-11 08:00:00+00:00,517,44,561,41,11.003
2017-05-11 09:00:00+00:00,591,50,641,40,12.101
2017-05-11 10:00:00+00:00,618,85,703,37,12.699
2017-05-11 11:00:00+00:00,625,124,749,36,13.04
2017-05-11 12:00:00+00:00,599,149,748,34,13.257
2017-05-11 13:00:00+00:00,529,235,764,34,13.194
2017-05-11 14:00:00+00:00,421,354,775,35,12.702
2017-05-11 15:00:00+00:00,295,605,900,38,11.511
2017-05-11 16:00:00+00:00,175,996,1171,40,9.848
2017-05-11 17:00:00+00:00,73,1295,1368,42,8.068
2017-05-11 18:00:00+00:00,16,1535,1551,40,6.551
2017-05-11 19:00:00+00:00,0,1632,1632,37,5.665
2017-05-11 20:00:00+00:00,0,1734,1734,32,5.25
2017-05-11 21:00:00+00:00,0,1848,1848,26,5.052
2017-05-11 22:00:00+00:00,0,1891,1891,25,5.011
2017-05-11 23:00:00+00:00,0,1653,1653,24,5.096
2017-05-12 00:00:00+00:00,0,1388,1388,23,5.463
2017-05-12 01:00:00+00:00,0,1126,1126,24,5.257
2017-05-12 02:00:00+00:00,0,855,855,25,4.795
2017-05-12 03:00:00+00:00,2,569,571,28,4.61
2017-05-12 04:00:00+00:00,34,409,443,33,5.528
2017-05-12 05:00:00+00:00,125,203,328,40,7.174
2017-05-12 06:00:00+00:00,232,115,347,43,8.216
2017-05-12 07:00:00+00:00,343,61,404,40,9.135
2017-05-12 08:00:00+00:00,437,69,506,39,10.377
2017-05-12 09:00:00+00:00,497,117,614,38,11.649
2017-05-12 10:00:00+00:00,530,373,903,35,12.562
2017-05-12 11:00:00+00:00,533,443,976,32,13.088
2017-05-12 12:00:00+00:00,524,329,853,31,12.978
2017-05-12 13:00:00+00:00,477,207,684,31,12.241
2017-05-12 14:00:00+00:00,390,164,554,31,11.422
2017-05-12 15:00:00+00:00,290,171,461,35,10.457
2017-05-12 16:00:00+00:00,181,192,373,38,9.493
2017-05-12 17:00:00+00:00,76,140,216,40,8.643
2017-05-12 18:00:00+00:00,16,193,209,40,7.785
2017-05-12 19:00:00+00:00,0,154,154,39,7.132
2017-05-12 20:00:00+00:00,0,101,101,36,6.781
2017-05-12 21:00:00+00:00,0,101,101,32,6.573
2017-05-12 22:00:00+00:00,0,79,79,34,6.161
2017-05-12 23:00:00+00:00,0,75,75,30,5.71
2017-05-13 00:00:00+00:00,0,76,76,30,5.303
2017-05-13 01:00:00+00:00,0,103,103,30,4.862
2017-05-13 02:00:00+00:00,0,167,167,29,4.494
2017-05-13 03:00:00+00:00,1,238,239,29,4.247
2017-05-13 04:00:00+00:00,30,454,484,31,4.621
2017-05-13 05:00:00+00:00,109,547,656,32,5.504
2017-05-13 06:00:00+00:00,207,608,815,35,6.828
2017-05-13 07:00:00+00:00,313,803,1116,35,8.208
2017-05-13 08:00:00+00:00,395,1015,1410,34,9.771
2017-05-13 09:00:00+00:00,451,1001,1452,32,11.111
2017-05-13 10:00:00+00:00,511,1473,1984,31,12.388
2017-05-13 11:00:00+00:00,510,1573,2083,30,13.003
2017-05-13 12:00:00+00:00,488,1661,2149,28,12.974
2017-05-13 13:00:00+00:00,453,1610,2063,27,12.482
2017-05-13 14:00:00+00:00,386,1113,1499,28,11.802
2017-05-13 15:00:00+00:00,291,813,1104,31,10.92
2017-05-13 16:00:00+00:00,185,688,873,34,10.134
2017-05-13 17:00:00+00:00,79,533,612,39,9.185
2017-05-13 18:00:00+00:00,17,595,612,39,8.032
2017-05-13 19:00:00+00:00,0,472,472,39,7.251
2017-05-13 20:00:00+00:00,0,284,284,38,6.127
2017-05-13 21:00:00+00:00,0,258,258,34,5.052
2017-05-13 22:00:00+00:00,0,259,259,32,4.455
2017-05-13 23:00:00+00:00,0,168,168,29,4.047
2017-05-14 00:00:00+00:00,0,178,178,28,3.719
2017-05-14 01:00:00+00:00,0,193,193,27,3.41
2017-05-14 02:00:00+00:00,0,175,175,28,3.236
2017-05-14 03:00:00+00:00,2,216,218,28,3.081
2017-05-14 04:00:00+00:00,39,253,292,23,3.66
2017-05-14 05:00:00+00:00,135,222,357,24,5.767
2017-05-14 06:00:00+00:00,255,147,402,26,7.991
2017-05-14 07:00:00+00:00,373,151,524,26,9.649
2017-05-14 08:00:00+00:00,471,195,666,26,11.155
2017-05-14 09:00:00+00:00,531,224,755,25,12.608
2017-05-14 10:00:00+00:00,568,226,794,24,13.62
2017-05-14 11:00:00+00:00,552,213,765,20,13.972
2017-05-14 12:00:00+00:00,531,190,721,15,13.815
2017-05-14 13:00:00+00:00,481,248,729,18,12.984
2017-05-14 14:00:00+00:00,394,331,725,20,11.709
2017-05-14 15:00:00+00:00,288,453,741,26,10.402
2017-05-14 16:00:00+00:00,173,270,443,31,9.442
2017-05-14 17:00:00+00:00,71,140,211,33,8.563
2017-05-14 18:00:00+00:00,16,184,200,36,7.142
2017-05-14 19:00:00+00:00,0,293,293,36,6.26
2017-05-14 20:00:00+00:00,0,301,301,37,5.659
2017-05-14 21:00:00+00:00,0,471,471,31,4.922
2017-05-14 22:00:00+00:00,0,601,601,30,4.079
2017-05-14 23:00:00+00:00,0,959,959,29,3.685
2017-05-15 00:00:00+00:00,0,931,931,27,3.565
2017-05-15 01:00:00+00:00,0,921,921,26,3.558
2017-05-15 02:00:00+00:00,0,1021,1021,27,3.698
2017-05-15 03:00:00+00:00,2,871,873,30,3.64
2017-05-15 04:00:00+00:00,32,695,727,39,3.879
2017-05-15 05:00:00+00:00,108,668,776,45,4.597
2017-05-15 06:00:00+00:00,191,677,868,46,5.28
2017-05-15 07:00:00+00:00,289,625,914,44,6.137
2017-05-15 08:00:00+00:00,365,655,1020,40,6.948
2017-05-15 09:00:00+00:00,407,628,1035,40,7.855
2017-05-15 10:00:00+00:00,423,569,992,36,8.908
2017-05-15 11:00:00+00:00,427,501,928,34,9.652
2017-05-15 12:00:00+00:00,398,516,914,32,10.049
2017-05-15 13:00:00+00:00,374,548,922,32,10.048
2017-05-15 14:00:00+00:00,339,613,952,34,9.867
2017-05-15 15:00:00+00:00,274,565,839,38,9.52
2017-05-15 16:00:00+00:00,171,317,488,43,8.863
2017-05-15 17:00:00+00:00,72,297,369,45,7.809
2017-05-15 18:00:00+00:00,17,506,523,45,6.199
2017-05-15 19:00:00+00:00,0,713,713,44,5.71
2017-05-15 20:00:00+00:00,0,791,791,40,5.469
2017-05-15 21:00:00+00:00,0,871,871,34,5.143
2017-05-15 22:00:00+00:00,0,919,919,30,4.814
2017-05-15 23:00:00+00:00,0,1008,1008,28,4.521
2017-05-16 00:00:00+00:00,0,1010,1010,27,4.32
2017-05-16 01:00:00+00:00,0,863,863,26,4.149
2017-05-16 02:00:00+00:00,0,770,770,27,4.081
2017-05-16 03:00:00+00:00,3,792,795,29,3.989
2017-05-16 04:00:00+00:00,45,820,865,34,4.813
2017-05-16 05:00:00+00:00,153,639,792,42,6.635
2017-05-16 06:00:00+00:00,287,394,681,44,8.581
2017-05-16 07:00:00+00:00,418,346,764,42,10.191
2017-05-16 08:00:00+00:00,510,310,820,39,12.161
2017-05-16 09:00:00+00:00,557,345,902,37,13.64
2017-05-16 10:00:00+00:00,558,422,980,34,14.699
2017-05-16 11:00:00+00:00,536,375,911,33,15.434
2017-05-16 12:00:00+00:00,503,304,807,33,15.788
2017-05-16 13:00:00+00:00,449,296,745,33,15.734
2017-05-16 14:00:00+00:00,372,358,730,34,15.221
2017-05-16 15:00:00+00:00,267,445,712,38,14.39
2017-05-16 16:00:00+00:00,167,482,649,40,13.237
2017-05-16 17:00:00+00:00,75,398,473,42,11.35
2017-05-16 18:00:00+00:00,17,366,383,42,9.116
2017-05-16 19:00:00+00:00,0,452,452,40,8.605
2017-05-16 20:00:00+00:00,0,494,494,37,8.489
2017-05-16 21:00:00+00:00,0,479,479,30,8.274
2017-05-16 22:00:00+00:00,0,458,458,30,7.936
2017-05-16 23:00:00+00:00,0,311,311,27,7.578
2017-05-17 00:00:00+00:00,0,230,230,26,7.238
2017-05-17 01:00:00+00:00,0,137,137,26,6.899
2017-05-17 02:00:00+00:00,0,85,85,26,6.556
2017-05-17 03:00:00+00:00,4,109,113,28,6.081
2017-05-17 04:00:00+00:00,47,115,162,35,6.351
2017-05-17 05:00:00+00:00,159,60,219,43,8.889
2017-05-17 06:00:00+00:00,299,21,320,43,11.627
2017-05-17 07:00:00+00:00,443,13,456,40,13.662
2017-05-17 08:00:00+00:00,565,18,583,37,15.039
2017-05-17 09:00:00+00:00,650,28,678,36,15.983
2017-05-17 10:00:00+00:00,699,33,732,33,16.642
2017-05-17 11:00:00+00:00,702,31,733,31,16.956
2017-05-17 12:00:00+00:00,680,29,709,31,16.887
2017-05-17 13:00:00+00:00,618,33,651,31,16.476
2017-05-17 14:00:00+00:00,507,38,545,31,15.73
2017-05-17 15:00:00+00:00,371,53,424,34,14.685
2017-05-17 16:00:00+00:00,229,73,302,37,13.605
2017-05-17 17:00:00+00:00,99,111,210,39,12.34
2017-05-17 18:00:00+00:00,23,160,183,37,10.345
2017-05-17 19:00:00+00:00,1,219,220,35,8.963
2017-05-17 20:00:00+00:00,0,275,275,31,8.376
2017-05-17 21:00:00+00:00,0,407,407,26,7.986
2017-05-17 22:00:00+00:00,0,593,593,24,7.661
2017-05-17 23:00:00+00:00,0,689,689,21,7.459
2017-05-18 00:00:00+00:00,0,761,761,19,7.282
2017-05-18 01:00:00+00:00,0,833,833,18,7.065
2017-05-18 02:00:00+00:00,0,945,945,20,6.831
2017-05-18 03:00:00+00:00,4,1185,1189,22,6.568
2017-05-18 04:00:00+00:00,50,1246,1296,30,7.566
2017-05-18 05:00:00+00:00,165,1046,1211,36,9.125
2017-05-18 06:00:00+00:00,308,941,1249,37,11.052
2017-05-18 07:00:00+00:00,453,1225,1678,35,13.863
2017-05-18 08:00:00+00:00,577,1624,2201,32,16.367
2017-05-18 09:00:00+00:00,669,1912,2581,32,17.643
2017-05-18 10:00:00+00:00,715,1891,2606,30,17.923
2017-05-18 11:00:00+00:00,721,1846,2567,31,17.797
2017-05-18 12:00:00+00:00,689,1722,2411,30,17.828
2017-05-18 13:00:00+00:00,616,1536,2152,31,17.445
2017-05-18 14:00:00+00:00,503,1345,1848,32,17.032
2017-05-18 15:00:00+00:00,369,1240,1609,37,16.805
2017-05-18 16:00:00+00:00,226,1172,1398,40,15.758
2017-05-18 17:00:00+00:00,97,1094,1191,43,13.426
2017-05-18 18:00:00+00:00,22,1276,1298,42,10.037
2017-05-18 19:00:00+00:00,1,1659,1660,40,8.353
2017-05-18 20:00:00+00:00,0,1889,1889,37,7.614
2017-05-18 21:00:00+00:00,0,1946,1946,32,6.854
2017-05-18 22:00:00+00:00,0,1931,1931,30,6.047
2017-05-18 23:00:00+00:00,0,1902,1902,28,5.393
2017-05-19 00:00:00+00:00,0,2001,2001,27,4.848
2017-05-19 01:00:00+00:00,0,1957,1957,26,4.384
2017-05-19 02:00:00+00:00,0,1897,1897,27,4.017
2017-05-19 03:00:00+00:00,4,1746,1750,29,3.735
2017-05-19 04:00:00+00:00,49,1459,1508,35,5.588
2017-05-19 05:00:00+00:00,162,1210,1372,42,8.097
2017-05-19 06:00:00+00:00,302,1376,1678,43,10.569
2017-05-19 07:00:00+00:00,445,1617,2062,41,12.91
2017-05-19 08:00:00+00:00,564,1746,2310,39,14.622
2017-05-19 09:00:00+00:00,645,1755,2400,37,15.719
2017-05-19 10:00:00+00:00,688,1842,2530,35,16.362
2017-05-19 11:00:00+00:00,717,1881,2598,34,16.688
2017-05-19 12:00:00+00:00,689,1911,2600,32,16.642
2017-05-19 13:00:00+00:00,620,1898,2518,31,16.201
2017-05-19 14:00:00+00:00,510,1860,2370,31,15.495
2017-05-19 15:00:00+00:00,374,1812,2186,34,14.534
2017-05-19 16:00:00+00:00,232,1683,1915,37,13.352
2017-05-19 17:00:00+00:00,100,1568,1668,38,11.498
2017-05-19 18:00:00+00:00,23,1603,1626,37,8.952
2017-05-19 19:00:00+00:00,1,1685,1686,35,7.782
2017-05-19 20:00:00+00:00,0,1663,1663,34,6.994
2017-05-19 21:00:00+00:00,0,1704,1704,29,6.123
2017-05-19 22:00:00+00:00,0,2120,2120,31,5.215
2017-05-19 23:00:00+00:00,0,2341,2341,28,4.483
2017-05-20 00:00:00+00:00,0,2310,2310,27,3.921
2017-05-20 01:00:00+00:00,0,2209,2209,27,3.27
2017-05-20 02:00:00+00:00,0,2137,2137,26,2.684
2017-05-20 03:00:00+00:00,4,2178,2182,28,1.829
2017-05-20 04:00:00+00:00,42,2219,2261,27,2.13
2017-05-20 05:00:00+00:00,139,2212,2351,29,3.387
2017-05-20 06:00:00+00:00,258,2200,2458,32,5.382
2017-05-20 07:00:00+00:00,373,2178,2551,32,7.444
2017-05-20 08:00:00+00:00,469,2129,2598,30,9.063
2017-05-20 09:00:00+00:00,531,2196,2727,29,10.265
2017-05-20 10:00:00+00:00,543,2205,2748,28,11.066
2017-05-20 11:00:00+00:00,522,2232,2754,28,11.338
2017-05-20 12:00:00+00:00,465,2265,2730,27,11.106
2017-05-20 13:00:00+00:00,391,2289,2680,28,10.517
2017-05-20 14:00:00+00:00,314,2284,2598,27,9.651
2017-05-20 15:00:00+00:00,233,2329,2562,31,8.55
2017-05-20 16:00:00+00:00,150,2324,2474,33,7.267
2017-05-20 17:00:00+00:00,66,2220,2286,38,5.859
2017-05-20 18:00:00+00:00,16,2249,2265,38,4.691
2017-05-20 19:00:00+00:00,0,2211,2211,39,4.242
2017-05-20 20:00:00+00:00,0,2167,2167,38,4.125
2017-05-20 21:00:00+00:00,0,2083,2083,32,4.064
2017-05-20 22:00:00+00:00,0,2020,2020,29,4.041
2017-05-20 23:00:00+00:00,0,2114,2114,28,3.986
2017-05-21 00:00:00+00:00,0,2076,2076,26,3.972
2017-05-21 01:00:00+00:00,0,1960,1960,25,3.889
2017-05-21 02:00:00+00:00,0,1792,1792,25,3.767
2017-05-21 03:00:00+00:00,2,1848,1850,24,3.631
2017-05-21 04:00:00+00:00,27,1887,1914,24,3.798
2017-05-21 05:00:00+00:00,88,1902,1990,23,4.171
2017-05-21 06:00:00+00:00,173,1886,2059,24,4.997
2017-05-21 07:00:00+00:00,273,1908,2181,24,6.088
2017-05-21 08:00:00+00:00,351,1922,2273,20,7.495
2017-05-21 09:00:00+00:00,400,1908,2308,23,9.058
2017-05-21 10:00:00+00:00,408,1903,2311,23,10.444
2017-05-21 11:00:00+00:00,409,1908,2317,20,11.629
2017-05-21 12:00:00+00:00,409,1977,2386,17,12.333
2017-05-21 13:00:00+00:00,386,2025,2411,19,12.668
2017-05-21 14:00:00+00:00,338,2040,2378,22,12.523
2017-05-21 15:00:00+00:00,269,1932,2201,27,11.999
2017-05-21 16:00:00+00:00,176,1782,1958,32,11.158
2017-05-21 17:00:00+00:00,81,1478,1559,36,9.85
2017-05-21 18:00:00+00:00,21,1342,1363,38,7.53
2017-05-21 19:00:00+00:00,1,1386,1387,38,6.67
2017-05-21 20:00:00+00:00,0,1014,1014,38,6.327
2017-05-21 21:00:00+00:00,0,756,756,33,5.973
2017-05-21 22:00:00+00:00,0,812,812,28,5.654
2017-05-21 23:00:00+00:00,0,923,923,27,5.184
2017-05-22 00:00:00+00:00,0,925,925,26,4.724
2017-05-22 01:00:00+00:00,0,900,900,26,4.398
2017-05-22 02:00:00+00:00,0,846,846,26,4.165
2017-05-22 03:00:00+00:00,4,799,803,28,3.879
2017-05-22 04:00:00+00:00,47,730,777,37,5.088
2017-05-22 05:00:00+00:00,152,579,731,43,7.676
2017-05-22 06:00:00+00:00,281,531,812,45,9.685
2017-05-22 07:00:00+00:00,411,435,846,39,12.062
2017-05-22 08:00:00+00:00,523,336,859,36,14.279
2017-05-22 09:00:00+00:00,607,268,875,36,15.627
2017-05-22 10:00:00+00:00,649,227,876,34,16.018
2017-05-22 11:00:00+00:00,658,182,840,34,15.992
2017-05-22 12:00:00+00:00,624,150,774,33,15.473
2017-05-22 13:00:00+00:00,549,120,669,33,14.371
2017-05-22 14:00:00+00:00,447,98,545,35,13.123
2017-05-22 15:00:00+00:00,326,81,407,39,11.946
2017-05-22 16:00:00+00:00,197,68,265,42,11.053
2017-05-22 17:00:00+00:00,86,144,230,45,10.045
2017-05-22 18:00:00+00:00,21,187,208,43,8.518
2017-05-22 19:00:00+00:00,1,192,193,41,8.005
2017-05-22 20:00:00+00:00,0,195,195,38,7.987
2017-05-22 21:00:00+00:00,0,110,110,31,7.741
2017-05-22 22:00:00+00:00,0,70,70,31,7.215
2017-05-22 23:00:00+00:00,0,108,108,28,6.619
2017-05-23 00:00:00+00:00,0,91,91,27,6.494
2017-05-23 01:00:00+00:00,0,113,113,27,6.516
2017-05-23 02:00:00+00:00,0,96,96,27,6.321
2017-05-23 03:00:00+00:00,4,78,82,28,5.947
2017-05-23 04:00:00+00:00,45,89,134,35,6.584
2017-05-23 05:00:00+00:00,150,69,219,41,9.127
2017-05-23 06:00:00+00:00,283,57,340,43,10.788
2017-05-23 07:00:00+00:00,423,46,469,40,12.067
2017-05-23 08:00:00+00:00,539,117,656,37,13.006
2017-05-23 09:00:00+00:00,625,143,768,37,13.751
2017-05-23 10:00:00+00:00,651,175,826,34,14.402
2017-05-23 11:00:00+00:00,648,187,835,33,14.591
2017-05-23 12:00:00+00:00,578,190,768,31,14.549
2017-05-23 13:00:00+00:00,499,199,698,31,14.46
2017-05-23 14:00:00+00:00,423,212,635,30,14.286
2017-05-23 15:00:00+00:00,323,189,512,34,13.668
2017-05-23 16:00:00+00:00,206,147,353,38,12.584
2017-05-23 17:00:00+00:00,99,193,292,39,11.163
2017-05-23 18:00:00+00:00,27,364,391,37,9.329
2017-05-23 19:00:00+00:00,1,471,472,36,8.72
2017-05-23 20:00:00+00:00,0,133,133,33,8.665
2017-05-23 21:00:00+00:00,0,89,89,28,8.487
2017-05-23 22:00:00+00:00,0,114,114,26,8.119
2017-05-23 23:00:00+00:00,0,128,128,24,7.602
2017-05-24 00:00:00+00:00,0,192,192,23,7.257
2017-05-24 01:00:00+00:00,0,251,251,21,7.176
2017-05-24 02:00:00+00:00,0,805,805,23,7.141
2017-05-24 03:00:00+00:00,2,751,753,25,7.212
2017-05-24 04:00:00+00:00,25,198,223,32,7.64
2017-05-24 05:00:00+00:00,83,217,300,36,8.241
2017-05-24 06:00:00+00:00,157,398,555,38,8.561
2017-05-24 07:00:00+00:00,249,825,1074,35,9.021
2017-05-24 08:00:00+00:00,347,926,1273,32,9.532
2017-05-24 09:00:00+00:00,413,733,1146,31,10.396
2017-05-24 10:00:00+00:00,454,697,1151,30,11.898
2017-05-24 11:00:00+00:00,448,1001,1449,29,12.777
2017-05-24 12:00:00+00:00,418,865,1283,29,12.494
2017-05-24 13:00:00+00:00,398,1038,1436,30,11.585
2017-05-24 14:00:00+00:00,350,1516,1866,29,10.413
2017-05-24 15:00:00+00:00,245,1970,2215,33,9.143
2017-05-24 16:00:00+00:00,165,1864,2029,36,7.94
2017-05-24 17:00:00+00:00,86,1586,1672,38,6.999
2017-05-24 18:00:00+00:00,24,1373,1397,38,6.336
2017-05-24 19:00:00+00:00,2,1145,1147,37,6.009
2017-05-24 20:00:00+00:00,0,677,677,36,5.663
2017-05-24 21:00:00+00:00,0,489,489,33,5.302
2017-05-24 22:00:00+00:00,0,657,657,30,4.721
2017-05-24 23:00:00+00:00,0,1016,1016,28,4.011
2017-05-25 00:00:00+00:00,0,1177,1177,26,3.648
2017-05-25 01:00:00+00:00,0,1253,1253,25,3.262
2017-05-25 02:00:00+00:00,0,1310,1310,24,2.915
2017-05-25 03:00:00+00:00,6,1396,1402,23,2.789
2017-05-25 04:00:00+00:00,51,1412,1463,24,3.378
2017-05-25 05:00:00+00:00,155,1414,1569,24,4.017
2017-05-25 06:00:00+00:00,272,1558,1830,24,5.116
2017-05-25 07:00:00+00:00,371,1676,2047,23,6.913
2017-05-25 08:00:00+00:00,449,1581,2030,20,8.783
2017-05-25 09:00:00+00:00,501,1225,1726,19,10.209
2017-05-25 10:00:00+00:00,528,1049,1577,18,11.448
2017-05-25 11:00:00+00:00,520,778,1298,14,12.301
2017-05-25 12:00:00+00:00,493,806,1299,12,12.651
2017-05-25 13:00:00+00:00,449,1015,1464,12,12.558
2017-05-25 14:00:00+00:00,382,1215,1597,15,11.992
2017-05-25 15:00:00+00:00,303,1232,1535,21,11.11
2017-05-25 16:00:00+00:00,211,1102,1313,27,9.923
2017-05-25 17:00:00+00:00,103,972,1075,31,8.488
2017-05-25 18:00:00+00:00,28,885,913,35,6.744
2017-05-25 19:00:00+00:00,2,937,939,34,5.813
2017-05-25 20:00:00+00:00,0,935,935,35,5.407
2017-05-25 21:00:00+00:00,0,951,951,31,5.056
2017-05-25 22:00:00+00:00,0,777,777,28,4.738
2017-05-25 23:00:00+00:00,0,636,636,26,4.366
2017-05-26 00:00:00+00:00,0,616,616,24,3.878
2017-05-26 01:00:00+00:00,0,568,568,24,3.606
2017-05-26 02:00:00+00:00,0,480,480,25,3.406
2017-05-26 03:00:00+00:00,6,369,375,26,3.189
2017-05-26 04:00:00+00:00,55,346,401,31,4.231
2017-05-26 05:00:00+00:00,172,321,493,38,6.749
2017-05-26 06:00:00+00:00,316,256,572,37,8.759
2017-05-26 07:00:00+00:00,454,280,734,37,10.4
2017-05-26 08:00:00+00:00,534,372,906,34,12.005
2017-05-26 09:00:00+00:00,574,434,1008,33,13.363
2017-05-26 10:00:00+00:00,589,532,1121,33,14.435
2017-05-26 11:00:00+00:00,578,591,1169,30,15.197
2017-05-26 12:00:00+00:00,540,615,1155,30,15.584
2017-05-26 13:00:00+00:00,499,683,1182,28,15.58
2017-05-26 14:00:00+00:00,419,766,1185,29,15.157
2017-05-26 15:00:00+00:00,311,747,1058,36,14.374
2017-05-26 16:00:00+00:00,207,640,847,39,13.232
2017-05-26 17:00:00+00:00,103,383,486,42,11.593
2017-05-26 18:00:00+00:00,29,226,255,43,9.07
2017-05-26 19:00:00+00:00,2,199,201,42,8.341
2017-05-26 20:00:00+00:00,0,214,214,42,8.23
2017-05-26 21:00:00+00:00,0,222,222,37,8.078
2017-05-26 22:00:00+00:00,0,221,221,32,7.911
2017-05-26 23:00:00+00:00,0,219,219,30,7.649
2017-05-27 00:00:00+00:00,0,176,176,29,7.342
2017-05-27 01:00:00+00:00,0,165,165,29,7.066
2017-05-27 02:00:00+00:00,0,225,225,27,6.775
2017-05-27 03:00:00+00:00,6,343,349,27,6.333
2017-05-27 04:00:00+00:00,58,388,446,28,6.804
2017-05-27 05:00:00+00:00,180,282,462,29,9.785
2017-05-27 06:00:00+00:00,327,184,511,29,11.973
2017-05-27 07:00:00+00:00,469,158,627,28,13.591
2017-05-27 08:00:00+00:00,583,239,822,25,15.126
2017-05-27 09:00:00+00:00,654,401,1055,22,16.447
2017-05-27 10:00:00+00:00,696,484,1180,19,17.465
2017-05-27 11:00:00+00:00,700,501,1201,18,18.151
2017-05-27 12:00:00+00:00,674,496,1170,15,18.477
2017-05-27 13:00:00+00:00,619,530,1149,15,18.438
2017-05-27 14:00:00+00:00,525,553,1078,18,17.999
2017-05-27 15:00:00+00:00,396,535,931,26,17.213
2017-05-27 16:00:00+00:00,249,550,799,31,16.363
2017-05-27 17:00:00+00:00,112,469,581,35,14.8
2017-05-27 18:00:00+00:00,28,449,477,35,12.178
2017-05-27 19:00:00+00:00,2,536,538,33,11.356
2017-05-27 20:00:00+00:00,0,554,554,31,10.91
2017-05-27 21:00:00+00:00,0,668,668,27,10.246
2017-05-27 22:00:00+00:00,0,512,512,19,9.496
2017-05-27 23:00:00+00:00,0,285,285,14,8.836
2017-05-28 00:00:00+00:00,0,328,328,11,8.284
2017-05-28 01:00:00+00:00,0,262,262,12,7.879
2017-05-28 02:00:00+00:00,0,253,253,15,7.536
2017-05-28 03:00:00+00:00,7,296,303,13,7.153
2017-05-28 04:00:00+00:00,59,219,278,13,8.09
2017-05-28 05:00:00+00:00,182,169,351,14,10.861
2017-05-28 06:00:00+00:00,330,175,505,15,13.402
2017-05-28 07:00:00+00:00,478,339,817,14,15.691
2017-05-28 08:00:00+00:00,605,249,854,14,17.267
2017-05-28 09:00:00+00:00,693,176,869,13,18.478
2017-05-28 10:00:00+00:00,732,177,909,12,19.353
2017-05-28 11:00:00+00:00,740,193,933,9,19.873
2017-05-28 12:00:00+00:00,707,203,910,4,20.032
2017-05-28 13:00:00+00:00,640,191,831,9,19.827
2017-05-28 14:00:00+00:00,532,205,737,13,19.239
2017-05-28 15:00:00+00:00,397,225,622,24,18.319
2017-05-28 16:00:00+00:00,250,267,517,30,17.689
2017-05-28 17:00:00+00:00,114,334,448,35,16.156
2017-05-28 18:00:00+00:00,29,425,454,36,13.638
2017-05-28 19:00:00+00:00,2,523,525,36,12.704
2017-05-28 20:00:00+00:00,0,735,735,37,11.732
2017-05-28 21:00:00+00:00,0,997,997,32,10.746
2017-05-28 22:00:00+00:00,0,1125,1125,31,10.087
2017-05-28 23:00:00+00:00,0,1181,1181,29,9.577
2017-05-29 00:00:00+00:00,0,1305,1305,27,9.093
2017-05-29 01:00:00+00:00,0,1294,1294,27,8.669
2017-05-29 02:00:00+00:00,0,1112,1112,28,8.269
2017-05-29 03:00:00+00:00,7,868,875,30,7.859
2017-05-29 04:00:00+00:00,57,615,672,38,8.758
2017-05-29 05:00:00+00:00,172,355,527,44,11.102
2017-05-29 06:00:00+00:00,310,195,505,44,13.791
2017-05-29 07:00:00+00:00,452,246,698,41,16.565
2017-05-29 08:00:00+00:00,574,362,936,38,18.134
2017-05-29 09:00:00+00:00,660,311,971,38,19.278
2017-05-29 10:00:00+00:00,699,238,937,35,20.092
2017-05-29 11:00:00+00:00,685,196,881,35,20.624
2017-05-29 12:00:00+00:00,634,162,796,34,20.827
2017-05-29 13:00:00+00:00,557,117,674,34,20.652
2017-05-29 14:00:00+00:00,446,72,518,35,20.061
2017-05-29 15:00:00+00:00,308,67,375,40,19.151
2017-05-29 16:00:00+00:00,199,78,277,45,18.91
2017-05-29 17:00:00+00:00,96,141,237,45,17.414
2017-05-29 18:00:00+00:00,23,280,303,45,15.016
2017-05-29 19:00:00+00:00,1,420,421,43,14.377
2017-05-29 20:00:00+00:00,0,502,502,41,14.066
2017-05-29 21:00:00+00:00,0,365,365,35,13.607
2017-05-29 22:00:00+00:00,0,323,323,34,13.075
2017-05-29 23:00:00+00:00,0,277,277,32,12.536
2017-05-30 00:00:00+00:00,0,167,167,30,12.091
2017-05-30 01:00:00+00:00,0,82,82,29,11.771
2017-05-30 02:00:00+00:00,0,76,76,29,11.502
2017-05-30 03:00:00+00:00,5,118,123,30,11.276
2017-05-30 04:00:00+00:00,46,129,175,38,11.726
2017-05-30 05:00:00+00:00,146,74,220,46,13.657
2017-05-30 06:00:00+00:00,265,29,294,45,15.462
2017-05-30 07:00:00+00:00,390,25,415,43,17.228
2017-05-30 08:00:00+00:00,496,64,560,41,18.535
2017-05-30 09:00:00+00:00,583,87,670,39,19.285
2017-05-30 10:00:00+00:00,643,76,719,35,19.719
2017-05-30 11:00:00+00:00,657,78,735,32,19.658
2017-05-30 12:00:00+00:00,631,85,716,31,18.986
2017-05-30 13:00:00+00:00,569,104,673,32,18.037
2017-05-30 14:00:00+00:00,472,127,599,31,17.98
2017-05-30 15:00:00+00:00,352,175,527,33,17.077
2017-05-30 16:00:00+00:00,222,254,476,37,15.799
2017-05-30 17:00:00+00:00,101,293,394,39,14.617
2017-05-30 18:00:00+00:00,26,469,495,40,13.399
2017-05-30 19:00:00+00:00,2,723,725,39,12.644
2017-05-30 20:00:00+00:00,0,774,774,36,11.833
2017-05-30 21:00:00+00:00,0,738,738,32,11.478
2017-05-30 22:00:00+00:00,0,931,931,31,11.616
2017-05-30 23:00:00+00:00,0,788,788,29,11.09
2017-05-31 00:00:00+00:00,0,248,248,26,10.927
2017-05-31 01:00:00+00:00,0,279,279,25,10.689
2017-05-31 02:00:00+00:00,0,301,301,26,10.323
2017-05-31 03:00:00+00:00,4,484,488,29,9.854
2017-05-31 04:00:00+00:00,41,463,504,35,10.418
2017-05-31 05:00:00+00:00,130,380,510,42,12.406
2017-05-31 06:00:00+00:00,240,335,575,43,16.446
2017-05-31 07:00:00+00:00,341,488,829,39,16.999
2017-05-31 08:00:00+00:00,423,522,945,35,17.469
2017-05-31 09:00:00+00:00,482,423,905,34,18.255
2017-05-31 10:00:00+00:00,497,313,810,31,18.806
2017-05-31 11:00:00+00:00,463,279,742,30,18.766
2017-05-31 12:00:00+00:00,430,290,720,29,18.083
2017-05-31 13:00:00+00:00,409,322,731,29,16.919
2017-05-31 14:00:00+00:00,363,163,526,31,15.918
2017-05-31 15:00:00+00:00,277,89,366,35,15.414
2017-05-31 16:00:00+00:00,178,145,323,41,14.58
2017-05-31 17:00:00+00:00,83,289,372,43,13.821
2017-05-31 18:00:00+00:00,22,244,266,42,12.945
2017-05-31 19:00:00+00:00,1,236,237,41,12.44
2017-05-31 20:00:00+00:00,0,219,219,40,12.261
2017-05-31 21:00:00+00:00,0,297,297,34,12.026
2017-05-31 22:00:00+00:00,0,244,244,32,11.761
2017-05-31 23:00:00+00:00,0,252,252,30,11.532
2017-06-01 00:00:00+00:00,0,335,335,29,11.209
2017-06-01 01:00:00+00:00,0,321,321,28,10.908
2017-06-01 02:00:00+00:00,0,249,249,29,10.736
2017-06-01 03:00:00+00:00,4,246,250,31,10.584
2017-06-01 04:00:00+00:00,41,202,243,38,11.052
2017-06-01 05:00:00+00:00,121,149,270,45,12.741
2017-06-01 06:00:00+00:00,207,140,347,45,13.948
2017-06-01 07:00:00+00:00,295,123,418,42,14.202
2017-06-01 08:00:00+00:00,376,116,492,39,14.53
2017-06-01 09:00:00+00:00,437,64,501,38,14.846
2017-06-01 10:00:00+00:00,476,80,556,33,14.892
2017-06-01 11:00:00+00:00,485,133,618,32,14.928
2017-06-01 12:00:00+00:00,447,163,610,32,14.72
2017-06-01 13:00:00+00:00,405,135,540,33,14.355
2017-06-01 14:00:00+00:00,360,96,456,35,13.793
2017-06-01 15:00:00+00:00,292,93,385,41,13.304
2017-06-01 16:00:00+00:00,195,85,280,45,12.713
2017-06-01 17:00:00+00:00,92,83,175,47,11.991
2017-06-01 18:00:00+00:00,25,84,109,47,11.27
2017-06-01 19:00:00+00:00,1,71,72,45,10.876
2017-06-01 20:00:00+00:00,0,48,48,43,10.674
2017-06-01 21:00:00+00:00,0,45,45,37,10.449
2017-06-01 22:00:00+00:00,0,39,39,33,10.23
2017-06-01 23:00:00+00:00,0,27,27,30,10.092
2017-06-02 00:00:00+00:00,0,22,22,30,10.053
2017-06-02 01:00:00+00:00,0,12,12,29,10.052
2017-06-02 02:00:00+00:00,0,3,3,29,9.982
2017-06-02 03:00:00+00:00,5,3,8,30,9.728
2017-06-02 04:00:00+00:00,48,7,55,37,9.706
2017-06-02 05:00:00+00:00,135,4,139,43,10.824
2017-06-02 06:00:00+00:00,239,2,241,43,13.28
2017-06-02 07:00:00+00:00,350,3,353,41,14.745
2017-06-02 08:00:00+00:00,442,11,453,39,14.825
2017-06-02 09:00:00+00:00,509,18,527,38,15.008
2017-06-02 10:00:00+00:00,547,29,576,34,15.792
2017-06-02 11:00:00+00:00,552,29,581,33,16.092
2017-06-02 12:00:00+00:00,531,17,548,33,15.833
2017-06-02 13:00:00+00:00,485,7,492,33,15.094
2017-06-02 14:00:00+00:00,411,6,417,33,14.674
2017-06-02 15:00:00+00:00,296,11,307,38,14.374
2017-06-02 16:00:00+00:00,190,7,197,42,13.401
2017-06-02 17:00:00+00:00,95,4,99,44,12.3
2017-06-02 18:00:00+00:00,25,12,37,43,11.504
2017-06-02 19:00:00+00:00,1,15,16,41,11.055
2017-06-02 20:00:00+00:00,0,17,17,40,10.743
2017-06-02 21:00:00+00:00,0,41,41,35,10.455
2017-06-02 22:00:00+00:00,0,42,42,32,10.231
2017-06-02 23:00:00+00:00,0,72,72,30,9.994
2017-06-03 00:00:00+00:00,0,49,49,29,9.685
2017-06-03 01:00:00+00:00,0,34,34,27,9.376
2017-06-03 02:00:00+00:00,0,51,51,27,9.075
2017-06-03 03:00:00+00:00,6,61,67,26,8.713
2017-06-03 04:00:00+00:00,54,41,95,27,9.256
2017-06-03 05:00:00+00:00,162,11,173,30,12.096
2017-06-03 06:00:00+00:00,291,1,292,32,14.819
2017-06-03 07:00:00+00:00,418,1,419,32,15.002
2017-06-03 08:00:00+00:00,516,1,517,31,16.287
2017-06-03 09:00:00+00:00,577,1,578,29,17.222
2017-06-03 10:00:00+00:00,587,5,592,28,17.881
2017-06-03 11:00:00+00:00,587,8,595,26,18.179
2017-06-03 12:00:00+00:00,555,15,570,26,18.186
2017-06-03 13:00:00+00:00,489,13,502,26,17.888
2017-06-03 14:00:00+00:00,414,20,434,27,17.048
2017-06-03 15:00:00+00:00,328,51,379,31,16.798
2017-06-03 16:00:00+00:00,221,60,281,35,16.191
2017-06-03 17:00:00+00:00,107,53,160,38,14.592
2017-06-03 18:00:00+00:00,29,58,87,37,12.313
2017-06-03 19:00:00+00:00,2,84,86,36,10.684
2017-06-03 20:00:00+00:00,0,142,142,36,9.917
2017-06-03 21:00:00+00:00,0,302,302,30,9.344
2017-06-03 22:00:00+00:00,0,467,467,28,8.913
2017-06-03 23:00:00+00:00,0,499,499,24,8.632
2017-06-04 00:00:00+00:00,0,501,501,22,8.357
2017-06-04 01:00:00+00:00,0,535,535,16,7.992
2017-06-04 02:00:00+00:00,0,687,687,15,7.58
2017-06-04 03:00:00+00:00,6,754,760,12,7.46
2017-06-04 04:00:00+00:00,47,734,781,11,9.54
2017-06-04 05:00:00+00:00,136,625,761,15,11.253
2017-06-04 06:00:00+00:00,240,564,804,17,12.918
2017-06-04 07:00:00+00:00,340,561,901,18,14.115
2017-06-04 08:00:00+00:00,404,430,834,16,14.237
2017-06-04 09:00:00+00:00,430,365,795,15,13.6
2017-06-04 10:00:00+00:00,426,479,905,12,13.153
2017-06-04 11:00:00+00:00,407,930,1337,8,13.032
2017-06-04 12:00:00+00:00,361,965,1326,5,13.122
2017-06-04 13:00:00+00:00,288,1079,1367,5,12.975
2017-06-04 14:00:00+00:00,253,1256,1509,7,12.381
2017-06-04 15:00:00+00:00,204,1442,1646,18,11.539
2017-06-04 16:00:00+00:00,135,1248,1383,26,10.691
2017-06-04 17:00:00+00:00,70,884,954,31,9.959
2017-06-04 18:00:00+00:00,23,795,818,33,8.992
2017-06-04 19:00:00+00:00,3,645,648,34,8.123
2017-06-04 20:00:00+00:00,0,649,649,36,7.872
2017-06-04 21:00:00+00:00,0,625,625,32,7.642
2017-06-04 22:00:00+00:00,0,683,683,27,7.372
2017-06-04 23:00:00+00:00,0,617,617,24,7.18
2017-06-05 00:00:00+00:00,0,535,535,23,6.885
2017-06-05 01:00:00+00:00,0,539,539,21,6.497
2017-06-05 02:00:00+00:00,0,569,569,21,6.163
2017-06-05 03:00:00+00:00,7,511,518,20,6.091
2017-06-05 04:00:00+00:00,49,351,400,21,7.077
2017-06-05 05:00:00+00:00,137,127,264,23,7.829
2017-06-05 06:00:00+00:00,233,40,273,25,8.701
2017-06-05 07:00:00+00:00,326,10,336,26,9.652
2017-06-05 08:00:00+00:00,411,8,419,24,10.499
2017-06-05 09:00:00+00:00,461,16,477,26,11.679
2017-06-05 10:00:00+00:00,481,18,499,24,13.258
2017-06-05 11:00:00+00:00,464,23,487,23,14.573
2017-06-05 12:00:00+00:00,444,24,468,22,15.461
2017-06-05 13:00:00+00:00,401,34,435,22,15.849
2017-06-05 14:00:00+00:00,329,37,366,25,15.5
2017-06-05 15:00:00+00:00,245,52,297,29,14.753
2017-06-05 16:00:00+00:00,163,71,234,33,13.437
2017-06-05 17:00:00+00:00,82,125,207,36,12.043
2017-06-05 18:00:00+00:00,23,242,265,37,10.529
2017-06-05 19:00:00+00:00,2,393,395,36,9.8
2017-06-05 20:00:00+00:00,0,486,486,36,9.586
2017-06-05 21:00:00+00:00,0,599,599,30,9.104
2017-06-05 22:00:00+00:00,0,749,749,28,8.559
2017-06-05 23:00:00+00:00,0,746,746,25,8.066
2017-06-06 00:00:00+00:00,0,680,680,23,7.77
2017-06-06 01:00:00+00:00,0,617,617,21,7.6
2017-06-06 02:00:00+00:00,0,551,551,22,7.635
2017-06-06 03:00:00+00:00,6,437,443,25,7.935
2017-06-06 04:00:00+00:00,51,358,409,32,8.692
2017-06-06 05:00:00+00:00,146,317,463,42,9.354
2017-06-06 06:00:00+00:00,248,516,764,43,10.232
2017-06-06 07:00:00+00:00,342,791,1133,43,11.216
2017-06-06 08:00:00+00:00,401,945,1346,39,12.349
2017-06-06 09:00:00+00:00,443,998,1441,40,13.225
2017-06-06 10:00:00+00:00,463,1057,1520,37,13.593
2017-06-06 11:00:00+00:00,447,1110,1557,35,13.535
2017-06-06 12:00:00+00:00,397,1166,1563,32,13.699
2017-06-06 13:00:00+00:00,361,1225,1586,33,13.721
2017-06-06 14:00:00+00:00,305,1097,1402,31,13.28
2017-06-06 15:00:00+00:00,241,1218,1459,35,11.985
2017-06-06 16:00:00+00:00,155,1183,1338,37,10.397
2017-06-06 17:00:00+00:00,76,1051,1127,38,8.463
2017-06-06 18:00:00+00:00,25,1284,1309,40,6.794
2017-06-06 19:00:00+00:00,3,1350,1353,39,5.421
2017-06-06 20:00:00+00:00,0,1405,1405,37,4.027
2017-06-06 21:00:00+00:00,0,1490,1490,27,3.105
2017-06-06 22:00:00+00:00,0,1415,1415,11,2.709
2017-06-06 23:00:00+00:00,0,1182,1182,7,2.422
2017-06-07 00:00:00+00:00,0,965,965,5,2.399
2017-06-07 01:00:00+00:00,0,777,777,4,2.413
2017-06-07 02:00:00+00:00,0,659,659,5,2.278
2017-06-07 03:00:00+00:00,6,641,647,8,2.231
2017-06-07 04:00:00+00:00,49,600,649,18,3.528
2017-06-07 05:00:00+00:00,145,555,700,24,4.875
2017-06-07 06:00:00+00:00,245,447,692,22,6.17
2017-06-07 07:00:00+00:00,334,367,701,18,7.736
2017-06-07 08:00:00+00:00,408,380,788,12,9.13
2017-06-07 09:00:00+00:00,460,360,820,10,10.284
2017-06-07 10:00:00+00:00,476,258,734,9,10.935
2017-06-07 11:00:00+00:00,458,164,622,6,11.038
2017-06-07 12:00:00+00:00,422,98,520,7,10.62
2017-06-07 13:00:00+00:00,367,107,474,7,9.534
2017-06-07 14:00:00+00:00,286,204,490,9,8.082
2017-06-07 15:00:00+00:00,201,377,578,15,6.333
2017-06-07 16:00:00+00:00,142,409,551,23,4.943
2017-06-07 17:00:00+00:00,75,423,498,27,4.445
2017-06-07 18:00:00+00:00,24,433,457,30,4.019
2017-06-07 19:00:00+00:00,3,511,514,30,3.226
2017-06-07 20:00:00+00:00,0,633,633,28,2.492
2017-06-07 21:00:00+00:00,0,786,786,21,1.953
2017-06-07 22:00:00+00:00,0,824,824,17,1.542
2017-06-07 23:00:00+00:00,0,876,876,13,1.171
2017-06-08 00:00:00+00:00,0,829,829,10,1.062
2017-06-08 01:00:00+00:00,0,822,822,11,1.03
2017-06-08 02:00:00+00:00,0,742,742,14,0.92
2017-06-08 03:00:00+00:00,9,639,648,21,0.741
2017-06-08 04:00:00+00:00,61,453,514,29,2.165
2017-06-08 05:00:00+00:00,174,266,440,38,5.112
2017-06-08 06:00:00+00:00,310,215,525,40,7.656
2017-06-08 07:00:00+00:00,442,160,602,37,10.39
2017-06-08 08:00:00+00:00,538,108,646,34,13.464
2017-06-08 09:00:00+00:00,607,128,735,33,16.318
2017-06-08 10:00:00+00:00,636,107,743,30,16.208
2017-06-08 11:00:00+00:00,632,75,707,30,16.122
2017-06-08 12:00:00+00:00,608,49,657,29,16.675
2017-06-08 13:00:00+00:00,547,24,571,29,16.799
2017-06-08 14:00:00+00:00,453,13,466,32,16.445
2017-06-08 15:00:00+00:00,345,7,352,36,15.55
2017-06-08 16:00:00+00:00,231,4,235,40,14.671
2017-06-08 17:00:00+00:00,113,7,120,45,13.127
2017-06-08 18:00:00+00:00,34,18,52,43,10.944
2017-06-08 19:00:00+00:00,4,38,42,40,9.8
2017-06-08 20:00:00+00:00,0,81,81,38,8.873
2017-06-08 21:00:00+00:00,0,140,140,31,8.094
2017-06-08 22:00:00+00:00,0,165,165,29,7.621
2017-06-08 23:00:00+00:00,0,129,129,25,7.336
2017-06-09 00:00:00+00:00,0,51,51,23,7.162
2017-06-09 01:00:00+00:00,0,15,15,20,7.041
2017-06-09 02:00:00+00:00,0,46,46,20,6.896
2017-06-09 03:00:00+00:00,8,116,124,25,6.549
2017-06-09 04:00:00+00:00,61,130,191,35,7.445
2017-06-09 05:00:00+00:00,176,86,262,39,10.171
2017-06-09 06:00:00+00:00,313,81,394,40,12.514
2017-06-09 07:00:00+00:00,446,189,635,39,14.692
2017-06-09 08:00:00+00:00,552,360,912,37,16.402
2017-06-09 09:00:00+00:00,618,455,1073,36,17.824
2017-06-09 10:00:00+00:00,651,409,1060,34,18.941
2017-06-09 11:00:00+00:00,651,425,1076,32,19.647
2017-06-09 12:00:00+00:00,624,505,1129,31,19.713
2017-06-09 13:00:00+00:00,573,516,1089,31,18.913
2017-06-09 14:00:00+00:00,488,554,1042,31,17.228
2017-06-09 15:00:00+00:00,371,514,885,32,15.405
2017-06-09 16:00:00+00:00,240,484,724,34,14.092
2017-06-09 17:00:00+00:00,113,393,506,37,12.751
2017-06-09 18:00:00+00:00,32,490,522,37,11.77
2017-06-09 19:00:00+00:00,3,635,638,36,10.818
2017-06-09 20:00:00+00:00,0,735,735,36,10.223
2017-06-09 21:00:00+00:00,0,691,691,32,9.68
2017-06-09 22:00:00+00:00,0,473,473,32,9.121
2017-06-09 23:00:00+00:00,0,251,251,29,8.728
2017-06-10 00:00:00+00:00,0,171,171,28,8.495
2017-06-10 01:00:00+00:00,0,513,513,28,8.189
2017-06-10 02:00:00+00:00,0,1071,1071,26,8.03
2017-06-10 03:00:00+00:00,3,1088,1091,26,7.96
2017-06-10 04:00:00+00:00,28,976,1004,27,8.676
2017-06-10 05:00:00+00:00,108,602,710,29,9.813
2017-06-10 06:00:00+00:00,218,454,672,31,10.338
2017-06-10 07:00:00+00:00,348,388,736,29,11.212
2017-06-10 08:00:00+00:00,455,397,852,27,12.52
2017-06-10 09:00:00+00:00,521,365,886,26,13.873
2017-06-10 10:00:00+00:00,550,379,929,25,15.051
2017-06-10 11:00:00+00:00,553,499,1052,23,15.803
2017-06-10 12:00:00+00:00,526,683,1209,22,16.144
2017-06-10 13:00:00+00:00,495,793,1288,24,16.219
2017-06-10 14:00:00+00:00,417,883,1300,25,15.877
2017-06-10 15:00:00+00:00,294,801,1095,30,15.152
2017-06-10 16:00:00+00:00,189,673,862,35,14.185
2017-06-10 17:00:00+00:00,96,353,449,39,12.907
2017-06-10 18:00:00+00:00,30,207,237,38,10.801
2017-06-10 19:00:00+00:00,3,161,164,38,9.87
2017-06-10 20:00:00+00:00,0,165,165,39,9.544
2017-06-10 21:00:00+00:00,0,142,142,35,9.164
2017-06-10 22:00:00+00:00,0,124,124,29,8.775
2017-06-10 23:00:00+00:00,0,121,121,27,8.224
2017-06-11 00:00:00+00:00,0,115,115,23,7.614
2017-06-11 01:00:00+00:00,0,105,105,21,7.081
2017-06-11 02:00:00+00:00,0,118,118,20,6.674
2017-06-11 03:00:00+00:00,8,136,144,17,6.417
2017-06-11 04:00:00+00:00,60,138,198,18,7.723
2017-06-11 05:00:00+00:00,174,116,290,17,9.919
2017-06-11 06:00:00+00:00,313,92,405,21,12.122
2017-06-11 07:00:00+00:00,447,99,546,19,14.083
2017-06-11 08:00:00+00:00,551,105,656,15,15.889
2017-06-11 09:00:00+00:00,616,114,730,15,17.435
2017-06-11 10:00:00+00:00,654,123,777,13,18.637
2017-06-11 11:00:00+00:00,650,101,751,13,19.513
2017-06-11 12:00:00+00:00,626,61,687,10,20.036
2017-06-11 13:00:00+00:00,584,42,626,10,20.184
2017-06-11 14:00:00+00:00,499,28,527,12,19.915
2017-06-11 15:00:00+00:00,382,16,398,22,19.255
2017-06-11 16:00:00+00:00,253,15,268,31,19.393
2017-06-11 17:00:00+00:00,123,19,142,35,18.536
2017-06-11 18:00:00+00:00,35,37,72,36,15.769
2017-06-11 19:00:00+00:00,3,57,60,35,14.296
2017-06-11 20:00:00+00:00,0,87,87,36,13.324
2017-06-11 21:00:00+00:00,0,114,114,31,12.353
2017-06-11 22:00:00+00:00,0,134,134,26,11.561
2017-06-11 23:00:00+00:00,0,169,169,21,11.227
2017-06-12 00:00:00+00:00,0,223,223,20,11.281
2017-06-12 01:00:00+00:00,0,232,232,17,11.243
2017-06-12 02:00:00+00:00,0,238,238,19,11.228
2017-06-12 03:00:00+00:00,6,289,295,20,11.116
2017-06-12 04:00:00+00:00,50,224,274,32,12.354
2017-06-12 05:00:00+00:00,146,137,283,37,14.991
2017-06-12 06:00:00+00:00,257,101,358,39,16.764
2017-06-12 07:00:00+00:00,366,107,473,37,18.226
2017-06-12 08:00:00+00:00,463,130,593,33,19.448
2017-06-12 09:00:00+00:00,541,149,690,33,20.463
2017-06-12 10:00:00+00:00,594,161,755,29,20.926
2017-06-12 11:00:00+00:00,614,210,824,29,20.943
2017-06-12 12:00:00+00:00,590,359,949,27,20.33
2017-06-12 13:00:00+00:00,523,512,1035,27,19.392
2017-06-12 14:00:00+00:00,445,422,867,27,18.536
2017-06-12 15:00:00+00:00,348,480,828,30,17.78
2017-06-12 16:00:00+00:00,228,469,697,32,16.929
2017-06-12 17:00:00+00:00,108,564,672,36,16.02
2017-06-12 18:00:00+00:00,30,653,683,35,14.651
2017-06-12 19:00:00+00:00,2,748,750,35,13.356
2017-06-12 20:00:00+00:00,0,954,954,33,12.83
2017-06-12 21:00:00+00:00,0,911,911,29,12.179
2017-06-12 22:00:00+00:00,0,916,916,21,11.669
2017-06-12 23:00:00+00:00,0,840,840,20,11.255
2017-06-13 00:00:00+00:00,0,847,847,18,10.806
2017-06-13 01:00:00+00:00,0,734,734,17,10.506
2017-06-13 02:00:00+00:00,0,618,618,18,10.195
2017-06-13 03:00:00+00:00,8,578,586,24,9.953
2017-06-13 04:00:00+00:00,61,428,489,30,11.226
2017-06-13 05:00:00+00:00,177,257,434,36,12.977
2017-06-13 06:00:00+00:00,312,207,519,38,14.5
2017-06-13 07:00:00+00:00,445,153,598,34,16.272
2017-06-13 08:00:00+00:00,551,167,718,31,17.81
2017-06-13 09:00:00+00:00,621,259,880,31,19.009
2017-06-13 10:00:00+00:00,642,311,953,28,19.96
2017-06-13 11:00:00+00:00,634,357,991,28,20.606
2017-06-13 12:00:00+00:00,613,349,962,27,20.76
2017-06-13 13:00:00+00:00,559,373,932,28,20.647
2017-06-13 14:00:00+00:00,474,383,857,30,20.117
2017-06-13 15:00:00+00:00,354,406,760,35,19.22
2017-06-13 16:00:00+00:00,230,426,656,41,18.187
2017-06-13 17:00:00+00:00,109,338,447,45,16.582
2017-06-13 18:00:00+00:00,30,360,390,42,14.172
2017-06-13 19:00:00+00:00,2,390,392,42,12.849
2017-06-13 20:00:00+00:00,0,454,454,42,12.313
2017-06-13 21:00:00+00:00,0,440,440,38,11.75
2017-06-13 22:00:00+00:00,0,342,342,32,11.218
2017-06-13 23:00:00+00:00,0,333,333,31,10.789
2017-06-14 00:00:00+00:00,0,326,326,29,10.226
2017-06-14 01:00:00+00:00,0,367,367,28,9.723
2017-06-14 02:00:00+00:00,0,397,397,29,9.336
2017-06-14 03:00:00+00:00,8,417,425,32,9.09
2017-06-14 04:00:00+00:00,56,325,381,38,10.223
2017-06-14 05:00:00+00:00,154,241,395,45,12.084
2017-06-14 06:00:00+00:00,265,211,476,46,13.96
2017-06-14 07:00:00+00:00,374,163,537,42,15.972
2017-06-14 08:00:00+00:00,465,187,652,39,17.296
2017-06-14 09:00:00+00:00,531,251,782,39,18.393
2017-06-14 10:00:00+00:00,586,281,867,36,19.204
2017-06-14 11:00:00+00:00,604,273,877,36,19.592
2017-06-14 12:00:00+00:00,586,247,833,36,19.464
2017-06-14 13:00:00+00:00,550,213,763,35,18.918
2017-06-14 14:00:00+00:00,466,200,666,37,18.158
2017-06-14 15:00:00+00:00,351,164,515,42,17.305
2017-06-14 16:00:00+00:00,229,119,348,44,16.91
2017-06-14 17:00:00+00:00,111,89,200,48,15.546
2017-06-14 18:00:00+00:00,33,137,170,46,13.374
2017-06-14 19:00:00+00:00,3,202,205,43,12.2
2017-06-14 20:00:00+00:00,0,171,171,43,11.801
2017-06-14 21:00:00+00:00,0,53,53,37,11.333
2017-06-14 22:00:00+00:00,0,22,22,34,10.912
2017-06-14 23:00:00+00:00,0,13,13,32,10.552
2017-06-15 00:00:00+00:00,0,12,12,30,10.189
2017-06-15 01:00:00+00:00,0,27,27,28,9.89
2017-06-15 02:00:00+00:00,0,63,63,28,9.667
2017-06-15 03:00:00+00:00,8,58,66,29,9.427
2017-06-15 04:00:00+00:00,61,37,98,32,10.415
2017-06-15 05:00:00+00:00,174,14,188,35,12.709
2017-06-15 06:00:00+00:00,310,4,314,36,15.229
2017-06-15 07:00:00+00:00,443,6,449,35,16.89
2017-06-15 08:00:00+00:00,552,4,556,32,18.109
2017-06-15 09:00:00+00:00,623,6,629,30,19.195
2017-06-15 10:00:00+00:00,655,7,662,29,20.044
2017-06-15 11:00:00+00:00,656,9,665,29,20.593
2017-06-15 12:00:00+00:00,629,8,637,28,20.784
2017-06-15 13:00:00+00:00,569,7,576,29,20.613
2017-06-15 14:00:00+00:00,474,6,480,31,20.003
2017-06-15 15:00:00+00:00,354,5,359,35,19
2017-06-15 16:00:00+00:00,233,9,242,38,18.332
2017-06-15 17:00:00+00:00,115,24,139,41,16.898
2017-06-15 18:00:00+00:00,32,75,107,38,15.522
2017-06-15 19:00:00+00:00,2,180,182,37,14.935
2017-06-15 20:00:00+00:00,0,270,270,38,14.056
2017-06-15 21:00:00+00:00,0,458,458,32,12.842
2017-06-15 22:00:00+00:00,0,530,530,27,11.893
2017-06-15 23:00:00+00:00,0,507,507,24,11.27
2017-06-16 00:00:00+00:00,0,386,386,23,10.822
2017-06-16 01:00:00+00:00,0,251,251,21,10.455
2017-06-16 02:00:00+00:00,0,232,232,21,10.202
2017-06-16 03:00:00+00:00,3,563,566,22,10.321
2017-06-16 04:00:00+00:00,23,544,567,29,11.312
2017-06-16 05:00:00+00:00,64,436,500,34,12.499
2017-06-16 06:00:00+00:00,153,209,362,35,12.894
2017-06-16 07:00:00+00:00,248,266,514,32,13.2
2017-06-16 08:00:00+00:00,342,339,681,25,13.402
2017-06-16 09:00:00+00:00,410,502,912,24,13.749
2017-06-16 10:00:00+00:00,456,590,1046,14,15.212
2017-06-16 11:00:00+00:00,493,685,1178,10,16.358
2017-06-16 12:00:00+00:00,504,781,1285,9,16.674
2017-06-16 13:00:00+00:00,494,859,1353,9,16.404
2017-06-16 14:00:00+00:00,440,883,1323,10,15.808
2017-06-16 15:00:00+00:00,347,806,1153,20,15.114
2017-06-16 16:00:00+00:00,239,561,800,26,14.119
2017-06-16 17:00:00+00:00,121,472,593,31,12.638
2017-06-16 18:00:00+00:00,36,297,333,31,11.137
2017-06-16 19:00:00+00:00,4,309,313,31,9.78
2017-06-16 20:00:00+00:00,0,407,407,30,8.988
2017-06-16 21:00:00+00:00,0,826,826,26,8.641
2017-06-16 22:00:00+00:00,0,1001,1001,20,8.334
2017-06-16 23:00:00+00:00,0,792,792,17,7.988
2017-06-17 00:00:00+00:00,0,786,786,14,7.622
2017-06-17 01:00:00+00:00,0,704,704,13,7.258
2017-06-17 02:00:00+00:00,0,832,832,13,6.936
2017-06-17 03:00:00+00:00,7,955,962,14,6.612
2017-06-17 04:00:00+00:00,54,992,1046,18,6.756
2017-06-17 05:00:00+00:00,160,1042,1202,22,7.224
2017-06-17 06:00:00+00:00,278,1152,1430,24,8.029
2017-06-17 07:00:00+00:00,393,1212,1605,25,8.932
2017-06-17 08:00:00+00:00,480,1249,1729,24,9.885
2017-06-17 09:00:00+00:00,529,1299,1828,24,10.861
2017-06-17 10:00:00+00:00,551,1395,1946,23,11.67
2017-06-17 11:00:00+00:00,548,1373,1921,21,12.108
2017-06-17 12:00:00+00:00,527,1202,1729,20,12.313
2017-06-17 13:00:00+00:00,488,962,1450,21,12.29
2017-06-17 14:00:00+00:00,423,947,1370,24,11.961
2017-06-17 15:00:00+00:00,324,854,1178,28,11.329
2017-06-17 16:00:00+00:00,208,678,886,33,10.395
2017-06-17 17:00:00+00:00,103,595,698,37,9.226
2017-06-17 18:00:00+00:00,34,574,608,36,7.904
2017-06-17 19:00:00+00:00,5,494,499,36,6.886
2017-06-17 20:00:00+00:00,0,649,649,37,6.595
2017-06-17 21:00:00+00:00,0,868,868,34,6.654
2017-06-17 22:00:00+00:00,0,1074,1074,29,6.776
2017-06-17 23:00:00+00:00,0,1020,1020,26,6.779
2017-06-18 00:00:00+00:00,0,1059,1059,25,6.603
2017-06-18 01:00:00+00:00,0,1026,1026,23,6.03
2017-06-18 02:00:00+00:00,0,935,935,22,5.43
2017-06-18 03:00:00+00:00,8,906,914,20,5.193
2017-06-18 04:00:00+00:00,60,821,881,21,6.197
2017-06-18 05:00:00+00:00,175,747,922,22,7.255
2017-06-18 06:00:00+00:00,311,771,1082,24,8.69
2017-06-18 07:00:00+00:00,438,763,1201,24,10.417
2017-06-18 08:00:00+00:00,534,777,1311,23,12.076
2017-06-18 09:00:00+00:00,600,724,1324,24,13.631
2017-06-18 10:00:00+00:00,636,669,1305,20,14.889
2017-06-18 11:00:00+00:00,642,710,1352,17,15.818
2017-06-18 12:00:00+00:00,617,724,1341,15,16.389
2017-06-18 13:00:00+00:00,563,670,1233,16,16.608
2017-06-18 14:00:00+00:00,484,587,1071,19,16.459
2017-06-18 15:00:00+00:00,380,507,887,25,15.933
2017-06-18 16:00:00+00:00,258,478,736,32,14.986
2017-06-18 17:00:00+00:00,127,330,457,37,13.641
2017-06-18 18:00:00+00:00,39,244,283,38,11.106
2017-06-18 19:00:00+00:00,4,207,211,38,9.904
2017-06-18 20:00:00+00:00,0,196,196,39,9.339
2017-06-18 21:00:00+00:00,0,183,183,34,8.627
2017-06-18 22:00:00+00:00,0,144,144,32,7.998
2017-06-18 23:00:00+00:00,0,130,130,30,7.422
2017-06-19 00:00:00+00:00,0,123,123,29,6.92
2017-06-19 01:00:00+00:00,0,142,142,28,6.42
2017-06-19 02:00:00+00:00,0,133,133,27,5.977
2017-06-19 03:00:00+00:00,9,105,114,30,5.692
2017-06-19 04:00:00+00:00,62,77,139,37,7.75
2017-06-19 05:00:00+00:00,175,45,220,43,10.344
2017-06-19 06:00:00+00:00,310,21,331,44,12.915
2017-06-19 07:00:00+00:00,443,22,465,42,15.523
2017-06-19 08:00:00+00:00,551,24,575,40,17.707
2017-06-19 09:00:00+00:00,623,22,645,38,19.272
2017-06-19 10:00:00+00:00,658,13,671,37,20.328
2017-06-19 11:00:00+00:00,663,12,675,37,20.96
2017-06-19 12:00:00+00:00,640,11,651,36,21.178
2017-06-19 13:00:00+00:00,590,9,599,36,21.026
2017-06-19 14:00:00+00:00,506,7,513,36,20.5
2017-06-19 15:00:00+00:00,389,6,395,42,19.645
2017-06-19 16:00:00+00:00,258,8,266,46,18.576
2017-06-19 17:00:00+00:00,126,11,137,49,17.445
2017-06-19 18:00:00+00:00,37,14,51,46,15.165
2017-06-19 19:00:00+00:00,4,20,24,44,14.314
2017-06-19 20:00:00+00:00,0,28,28,43,13.633
2017-06-19 21:00:00+00:00,0,44,44,36,12.602
2017-06-19 22:00:00+00:00,0,54,54,35,11.799
2017-06-19 23:00:00+00:00,0,60,60,32,11.28
2017-06-20 00:00:00+00:00,0,55,55,31,10.963
2017-06-20 01:00:00+00:00,0,40,40,31,10.747
2017-06-20 02:00:00+00:00,0,35,35,30,10.59
2017-06-20 03:00:00+00:00,8,49,57,31,10.395
2017-06-20 04:00:00+00:00,61,91,152,38,11.683
2017-06-20 05:00:00+00:00,175,63,238,45,14.399
2017-06-20 06:00:00+00:00,311,40,351,46,16.887
2017-06-20 07:00:00+00:00,444,50,494,44,18.529
2017-06-20 08:00:00+00:00,550,65,615,40,19.888
2017-06-20 09:00:00+00:00,617,61,678,38,21.02
2017-06-20 10:00:00+00:00,649,45,694,35,21.718
2017-06-20 11:00:00+00:00,648,59,707,34,21.935
2017-06-20 12:00:00+00:00,623,93,716,32,21.537
2017-06-20 13:00:00+00:00,574,115,689,33,20.987
2017-06-20 14:00:00+00:00,486,112,598,33,19.992
2017-06-20 15:00:00+00:00,367,104,471,37,19.79
2017-06-20 16:00:00+00:00,238,129,367,40,18.536
2017-06-20 17:00:00+00:00,116,173,289,42,16.986
2017-06-20 18:00:00+00:00,33,243,276,40,15.656
2017-06-20 19:00:00+00:00,2,196,198,39,15.096
2017-06-20 20:00:00+00:00,0,133,133,38,15.105
2017-06-20 21:00:00+00:00,0,106,106,32,14.796
2017-06-20 22:00:00+00:00,0,130,130,32,14.344
2017-06-20 23:00:00+00:00,0,188,188,31,14.073
2017-06-21 00:00:00+00:00,0,261,261,30,13.79
2017-06-21 01:00:00+00:00,0,387,387,29,13.483
2017-06-21 02:00:00+00:00,0,485,485,29,13.222
2017-06-21 03:00:00+00:00,5,449,454,31,12.861
2017-06-21 04:00:00+00:00,48,496,544,38,13.415
2017-06-21 05:00:00+00:00,146,373,519,45,15.823
2017-06-21 06:00:00+00:00,267,171,438,46,17.494
2017-06-21 07:00:00+00:00,391,142,533,43,17.925
2017-06-21 08:00:00+00:00,494,137,631,41,19.077
2017-06-21 09:00:00+00:00,558,134,692,40,19.863
2017-06-21 10:00:00+00:00,580,105,685,37,20.306
2017-06-21 11:00:00+00:00,551,95,646,37,20.26
2017-06-21 12:00:00+00:00,488,88,576,37,19.717
2017-06-21 13:00:00+00:00,438,103,541,37,19.565
2017-06-21 14:00:00+00:00,375,93,468,39,19.341
2017-06-21 15:00:00+00:00,303,85,388,43,18.378
2017-06-21 16:00:00+00:00,218,105,323,46,17.71
2017-06-21 17:00:00+00:00,101,99,200,50,16.667
2017-06-21 18:00:00+00:00,25,63,88,47,15.96
2017-06-21 19:00:00+00:00,2,40,42,45,15.028
2017-06-21 20:00:00+00:00,0,49,49,44,13.928
2017-06-21 21:00:00+00:00,0,86,86,38,13.298
2017-06-21 22:00:00+00:00,0,84,84,34,13.119
2017-06-21 23:00:00+00:00,0,52,52,33,12.796
2017-06-22 00:00:00+00:00,0,38,38,32,12.385
2017-06-22 01:00:00+00:00,0,26,26,31,12.186
2017-06-22 02:00:00+00:00,0,23,23,30,12.093
2017-06-22 03:00:00+00:00,6,43,49,31,12.014
2017-06-22 04:00:00+00:00,55,44,99,39,12.895
2017-06-22 05:00:00+00:00,164,17,181,46,15.776
2017-06-22 06:00:00+00:00,296,9,305,46,17.212
2017-06-22 07:00:00+00:00,424,6,430,43,18.736
2017-06-22 08:00:00+00:00,521,7,528,39,20.005
2017-06-22 09:00:00+00:00,581,13,594,38,21.205
2017-06-22 10:00:00+00:00,612,26,638,34,22.085
2017-06-22 11:00:00+00:00,613,47,660,32,22.611
2017-06-22 12:00:00+00:00,573,87,660,31,22.861
2017-06-22 13:00:00+00:00,509,93,602,31,22.802
2017-06-22 14:00:00+00:00,423,80,503,33,22.309
2017-06-22 15:00:00+00:00,319,73,392,37,21.48
2017-06-22 16:00:00+00:00,219,82,301,38,20.636
2017-06-22 17:00:00+00:00,109,124,233,41,18.791
2017-06-22 18:00:00+00:00,30,193,223,39,17.332
2017-06-22 19:00:00+00:00,2,304,306,37,15.981
2017-06-22 20:00:00+00:00,0,355,355,36,15.271
2017-06-22 21:00:00+00:00,0,242,242,30,14.922
2017-06-22 22:00:00+00:00,0,148,148,27,14.167
2017-06-22 23:00:00+00:00,0,163,163,24,13.449
2017-06-23 00:00:00+00:00,0,243,243,22,13.201
2017-06-23 01:00:00+00:00,0,358,358,20,13.074
2017-06-23 02:00:00+00:00,0,1108,1108,21,13.023
2017-06-23 03:00:00+00:00,4,370,374,24,12.74
2017-06-23 04:00:00+00:00,48,326,374,30,13.087
2017-06-23 05:00:00+00:00,152,292,444,38,15.013
2017-06-23 06:00:00+00:00,270,444,714,38,16.9
2017-06-23 07:00:00+00:00,377,895,1272,36,18.119
2017-06-23 08:00:00+00:00,448,597,1045,33,19.156
2017-06-23 09:00:00+00:00,487,784,1271,31,19.627
2017-06-23 10:00:00+00:00,482,972,1454,28,19.814
2017-06-23 11:00:00+00:00,447,892,1339,26,19.89
2017-06-23 12:00:00+00:00,431,756,1187,24,20.057
2017-06-23 13:00:00+00:00,404,618,1022,25,19.276
2017-06-23 14:00:00+00:00,352,432,784,28,18.538
2017-06-23 15:00:00+00:00,284,354,638,32,17.826
2017-06-23 16:00:00+00:00,203,307,510,36,17.418
2017-06-23 17:00:00+00:00,108,237,345,40,16.984
2017-06-23 18:00:00+00:00,32,208,240,40,15.645
2017-06-23 19:00:00+00:00,2,291,293,38,14.731
2017-06-23 20:00:00+00:00,0,321,321,39,14.238
2017-06-23 21:00:00+00:00,0,277,277,33,14.002
2017-06-23 22:00:00+00:00,0,223,223,30,13.617
2017-06-23 23:00:00+00:00,0,206,206,27,13.19
2017-06-24 00:00:00+00:00,0,202,202,26,12.837
2017-06-24 01:00:00+00:00,0,195,195,25,12.604
2017-06-24 02:00:00+00:00,0,173,173,23,12.264
2017-06-24 03:00:00+00:00,6,189,195,22,11.906
2017-06-24 04:00:00+00:00,55,160,215,21,13.071
2017-06-24 05:00:00+00:00,167,109,276,23,15.052
2017-06-24 06:00:00+00:00,299,75,374,23,16.495
2017-06-24 07:00:00+00:00,429,96,525,23,18.304
2017-06-24 08:00:00+00:00,529,169,698,17,19.8
2017-06-24 09:00:00+00:00,596,420,1016,15,20.72
2017-06-24 10:00:00+00:00,621,568,1189,11,21.082
2017-06-24 11:00:00+00:00,598,791,1389,10,20.94
2017-06-24 12:00:00+00:00,585,837,1422,9,20.583
2017-06-24 13:00:00+00:00,543,717,1260,9,20.129
2017-06-24 14:00:00+00:00,468,646,1114,12,19.22
2017-06-24 15:00:00+00:00,363,537,900,18,18.023
2017-06-24 16:00:00+00:00,238,394,632,28,17.062
2017-06-24 17:00:00+00:00,113,335,448,29,16.228
2017-06-24 18:00:00+00:00,31,442,473,33,15.25
2017-06-24 19:00:00+00:00,3,584,587,33,14.319
2017-06-24 20:00:00+00:00,0,713,713,35,14.178
2017-06-24 21:00:00+00:00,0,808,808,31,14.08
2017-06-24 22:00:00+00:00,0,719,719,25,13.332
2017-06-24 23:00:00+00:00,0,636,636,20,13.072
2017-06-25 00:00:00+00:00,0,440,440,18,12.626
2017-06-25 01:00:00+00:00,0,322,322,15,12.135
2017-06-25 02:00:00+00:00,0,191,191,15,12.27
2017-06-25 03:00:00+00:00,3,113,116,14,12.497
2017-06-25 04:00:00+00:00,37,28,65,12,13.016
2017-06-25 05:00:00+00:00,115,30,145,12,13.609
2017-06-25 06:00:00+00:00,216,29,245,12,13.932
2017-06-25 07:00:00+00:00,319,25,344,9,15.326
2017-06-25 08:00:00+00:00,368,48,416,7,15.738
2017-06-25 09:00:00+00:00,390,74,464,7,15.326
2017-06-25 10:00:00+00:00,402,104,506,5,15.092
2017-06-25 11:00:00+00:00,391,122,513,-3,15.006
2017-06-25 12:00:00+00:00,331,168,499,-5,14.479
2017-06-25 13:00:00+00:00,271,648,919,-5,13.331
2017-06-25 14:00:00+00:00,258,921,1179,-1,11.646
2017-06-25 15:00:00+00:00,235,1154,1389,6,10.437
2017-06-25 16:00:00+00:00,178,765,943,16,9.884
2017-06-25 17:00:00+00:00,95,463,558,26,9.893
2017-06-25 18:00:00+00:00,32,405,437,27,9.735
2017-06-25 19:00:00+00:00,4,456,460,29,9.185
2017-06-25 20:00:00+00:00,0,639,639,32,8.909
2017-06-25 21:00:00+00:00,0,681,681,28,8.854
2017-06-25 22:00:00+00:00,0,694,694,25,8.879
2017-06-25 23:00:00+00:00,0,785,785,23,8.509
2017-06-26 00:00:00+00:00,0,740,740,21,8.176
2017-06-26 01:00:00+00:00,0,650,650,20,8.204
2017-06-26 02:00:00+00:00,0,531,531,21,8.254
2017-06-26 03:00:00+00:00,6,452,458,26,8.288
2017-06-26 04:00:00+00:00,53,448,501,34,9.81
2017-06-26 05:00:00+00:00,161,261,422,41,11.92
2017-06-26 06:00:00+00:00,292,210,502,42,13.446
2017-06-26 07:00:00+00:00,420,198,618,38,15.221
2017-06-26 08:00:00+00:00,518,216,734,34,17.053
2017-06-26 09:00:00+00:00,590,297,887,33,18.681
2017-06-26 10:00:00+00:00,626,251,877,31,19.983
2017-06-26 11:00:00+00:00,632,163,795,31,20.843
2017-06-26 12:00:00+00:00,613,133,746,30,21.221
2017-06-26 13:00:00+00:00,567,119,686,33,21.138
2017-06-26 14:00:00+00:00,488,103,591,35,20.621
2017-06-26 15:00:00+00:00,379,78,457,39,19.817
2017-06-26 16:00:00+00:00,253,38,291,43,19.224
2017-06-26 17:00:00+00:00,123,20,143,46,17.72
2017-06-26 18:00:00+00:00,35,52,87,45,15.23
2017-06-26 19:00:00+00:00,3,148,151,44,13.755
2017-06-26 20:00:00+00:00,0,257,257,43,12.947
2017-06-26 21:00:00+00:00,0,295,295,36,12.325
2017-06-26 22:00:00+00:00,0,305,305,34,11.75
2017-06-26 23:00:00+00:00,0,294,294,32,11.439
2017-06-27 00:00:00+00:00,0,255,255,31,11.283
2017-06-27 01:00:00+00:00,0,170,170,30,11.147
2017-06-27 02:00:00+00:00,0,192,192,30,10.815
2017-06-27 03:00:00+00:00,4,229,233,32,10.368
2017-06-27 04:00:00+00:00,42,236,278,39,11.595
2017-06-27 05:00:00+00:00,121,214,335,44,13.437
2017-06-27 06:00:00+00:00,213,270,483,50,15.249
2017-06-27 07:00:00+00:00,309,501,810,48,16.864
2017-06-27 08:00:00+00:00,398,695,1093,44,17.748
2017-06-27 09:00:00+00:00,479,824,1303,43,17.868
2017-06-27 10:00:00+00:00,515,719,1234,40,17.886
2017-06-27 11:00:00+00:00,513,723,1236,40,17.812
2017-06-27 12:00:00+00:00,495,714,1209,39,17.79
2017-06-27 13:00:00+00:00,437,687,1124,39,17.671
2017-06-27 14:00:00+00:00,372,799,1171,40,17.563
2017-06-27 15:00:00+00:00,290,801,1091,43,17.163
2017-06-27 16:00:00+00:00,182,750,932,45,16.803
2017-06-27 17:00:00+00:00,88,573,661,46,15.568
2017-06-27 18:00:00+00:00,27,584,611,42,13.361
2017-06-27 19:00:00+00:00,2,631,633,39,11.373
2017-06-27 20:00:00+00:00,0,656,656,38,10.553
2017-06-27 21:00:00+00:00,0,675,675,32,10.021
2017-06-27 22:00:00+00:00,0,656,656,29,9.584
2017-06-27 23:00:00+00:00,0,625,625,28,9.422
2017-06-28 00:00:00+00:00,0,644,644,26,9.567
2017-06-28 01:00:00+00:00,0,614,614,25,9.762
2017-06-28 02:00:00+00:00,0,521,521,25,9.707
2017-06-28 03:00:00+00:00,5,474,479,26,9.887
2017-06-28 04:00:00+00:00,48,382,430,34,11.372
2017-06-28 05:00:00+00:00,148,315,463,41,13.005
2017-06-28 06:00:00+00:00,269,467,736,42,14.73
2017-06-28 07:00:00+00:00,393,710,1103,41,16.436
2017-06-28 08:00:00+00:00,487,1005,1492,39,17.854
2017-06-28 09:00:00+00:00,552,1171,1723,37,18.654
2017-06-28 10:00:00+00:00,586,1231,1817,36,18.867
2017-06-28 11:00:00+00:00,573,1256,1829,35,18.188
2017-06-28 12:00:00+00:00,525,1211,1736,34,17.327
2017-06-28 13:00:00+00:00,442,1284,1726,34,16.697
2017-06-28 14:00:00+00:00,350,1285,1635,34,16.308
2017-06-28 15:00:00+00:00,266,1192,1458,39,15.559
2017-06-28 16:00:00+00:00,188,1131,1319,41,14.522
2017-06-28 17:00:00+00:00,98,1209,1307,42,13.218
2017-06-28 18:00:00+00:00,28,1128,1156,40,12.196
2017-06-28 19:00:00+00:00,2,1191,1193,38,11.387
2017-06-28 20:00:00+00:00,0,1135,1135,38,10.673
2017-06-28 21:00:00+00:00,0,1119,1119,33,9.684
2017-06-28 22:00:00+00:00,0,907,907,31,9.194
2017-06-28 23:00:00+00:00,0,746,746,30,9.115
2017-06-29 00:00:00+00:00,0,1127,1127,28,9.254
2017-06-29 01:00:00+00:00,0,1120,1120,28,8.992
2017-06-29 02:00:00+00:00,0,1171,1171,28,8.362
2017-06-29 03:00:00+00:00,5,1035,1040,29,8.015
2017-06-29 04:00:00+00:00,40,1007,1047,36,8.676
2017-06-29 05:00:00+00:00,131,827,958,43,9.22
2017-06-29 06:00:00+00:00,234,641,875,47,10.173
2017-06-29 07:00:00+00:00,316,637,953,47,10.606
2017-06-29 08:00:00+00:00,405,674,1079,46,11.544
2017-06-29 09:00:00+00:00,457,781,1238,46,12.782
2017-06-29 10:00:00+00:00,476,893,1369,44,14.053
2017-06-29 11:00:00+00:00,450,820,1270,41,14.86
2017-06-29 12:00:00+00:00,412,1069,1481,39,15.007
2017-06-29 13:00:00+00:00,384,866,1250,38,14.482
2017-06-29 14:00:00+00:00,358,521,879,37,13.563
2017-06-29 15:00:00+00:00,306,588,894,39,12.689
2017-06-29 16:00:00+00:00,225,524,749,40,11.98
2017-06-29 17:00:00+00:00,119,327,446,41,11.377
2017-06-29 18:00:00+00:00,37,251,288,38,10.276
2017-06-29 19:00:00+00:00,5,269,274,36,9.027
2017-06-29 20:00:00+00:00,0,335,335,34,8.342
2017-06-29 21:00:00+00:00,0,326,326,30,7.876
2017-06-29 22:00:00+00:00,0,226,226,30,7.598
2017-06-29 23:00:00+00:00,0,258,258,28,7.226
2017-06-30 00:00:00+00:00,0,565,565,26,6.713
2017-06-30 01:00:00+00:00,0,764,764,25,6.412
2017-06-30 02:00:00+00:00,0,786,786,25,6.225
2017-06-30 03:00:00+00:00,6,712,718,26,6.191
2017-06-30 04:00:00+00:00,51,658,709,32,7.61
2017-06-30 05:00:00+00:00,152,638,790,36,8.773
2017-06-30 06:00:00+00:00,271,830,1101,38,10.062
2017-06-30 07:00:00+00:00,396,881,1277,36,11.306
2017-06-30 08:00:00+00:00,495,850,1345,34,12.415
2017-06-30 09:00:00+00:00,564,702,1266,33,13.417
2017-06-30 10:00:00+00:00,597,492,1089,31,13.875
2017-06-30 11:00:00+00:00,587,345,932,29,13.805
2017-06-30 12:00:00+00:00,554,212,766,27,12.844
2017-06-30 13:00:00+00:00,502,146,648,27,12.184
2017-06-30 14:00:00+00:00,429,77,506,28,12.118
2017-06-30 15:00:00+00:00,331,135,466,32,12.185
2017-06-30 16:00:00+00:00,223,306,529,35,11.266
2017-06-30 17:00:00+00:00,112,494,606,38,10.263
2017-06-30 18:00:00+00:00,35,331,366,36,9.292
2017-06-30 19:00:00+00:00,4,269,273,35,8.561
2017-06-30 20:00:00+00:00,0,355,355,35,8.254
2017-06-30 21:00:00+00:00,0,281,281,31,8.113
2017-06-30 22:00:00+00:00,0,313,313,30,8.025
2017-06-30 23:00:00+00:00,0,134,134,27,7.684
2017-07-01 00:00:00+00:00,0,200,200,25,7.173
2017-07-01 01:00:00+00:00,0,179,179,24,6.606
2017-07-01 02:00:00+00:00,0,202,202,23,6.325
2017-07-01 03:00:00+00:00,4,303,307,24,6.158
2017-07-01 04:00:00+00:00,40,484,524,24,6.585
2017-07-01 05:00:00+00:00,121,604,725,27,7.173
2017-07-01 06:00:00+00:00,227,1025,1252,30,8.966
2017-07-01 07:00:00+00:00,342,1137,1479,31,9.965
2017-07-01 08:00:00+00:00,448,870,1318,29,11.777
2017-07-01 09:00:00+00:00,535,926,1461,28,13.431
2017-07-01 10:00:00+00:00,600,965,1565,28,14.268
2017-07-01 11:00:00+00:00,603,905,1508,26,14.6
2017-07-01 12:00:00+00:00,543,1028,1571,25,14.488
2017-07-01 13:00:00+00:00,494,1028,1522,24,13.778
2017-07-01 14:00:00+00:00,423,799,1222,25,12.568
2017-07-01 15:00:00+00:00,327,643,970,28,11.51
2017-07-01 16:00:00+00:00,223,492,715,32,10.665
2017-07-01 17:00:00+00:00,111,345,456,33,9.896
2017-07-01 18:00:00+00:00,35,278,313,32,8.844
2017-07-01 19:00:00+00:00,4,656,660,32,8.266
2017-07-01 20:00:00+00:00,0,703,703,32,7.794
2017-07-01 21:00:00+00:00,0,506,506,27,7.101
2017-07-01 22:00:00+00:00,0,601,601,26,6.468
2017-07-01 23:00:00+00:00,0,634,634,21,5.883
2017-07-02 00:00:00+00:00,0,640,640,19,5.457
2017-07-02 01:00:00+00:00,0,824,824,16,5.164
2017-07-02 02:00:00+00:00,0,1093,1093,14,4.796
2017-07-02 03:00:00+00:00,4,1250,1254,13,4.888
2017-07-02 04:00:00+00:00,39,1196,1235,14,6.384
2017-07-02 05:00:00+00:00,119,1340,1459,16,7.25
2017-07-02 06:00:00+00:00,209,1738,1947,20,8.029
2017-07-02 07:00:00+00:00,288,1807,2095,21,9.109
2017-07-02 08:00:00+00:00,336,1673,2009,19,10.114
2017-07-02 09:00:00+00:00,366,1319,1685,19,10.802
2017-07-02 10:00:00+00:00,403,1055,1458,17,11.387
2017-07-02 11:00:00+00:00,419,1062,1481,14,11.874
2017-07-02 12:00:00+00:00,397,887,1284,10,12.425
2017-07-02 13:00:00+00:00,360,799,1159,10,12.905
2017-07-02 14:00:00+00:00,324,695,1019,14,13.037
2017-07-02 15:00:00+00:00,268,452,720,20,12.501
2017-07-02 16:00:00+00:00,198,566,764,28,11.68
2017-07-02 17:00:00+00:00,105,579,684,32,10.532
2017-07-02 18:00:00+00:00,36,770,806,34,9.29
2017-07-02 19:00:00+00:00,6,1010,1016,35,8.672
2017-07-02 20:00:00+00:00,0,1270,1270,37,8.419
2017-07-02 21:00:00+00:00,0,1305,1305,34,8.158
2017-07-02 22:00:00+00:00,0,1013,1013,29,7.755
2017-07-02 23:00:00+00:00,0,984,984,27,7.436
2017-07-03 00:00:00+00:00,0,1057,1057,27,7.051
2017-07-03 01:00:00+00:00,0,1105,1105,26,6.752
2017-07-03 02:00:00+00:00,0,1115,1115,26,6.252
2017-07-03 03:00:00+00:00,4,1213,1217,28,6.21
2017-07-03 04:00:00+00:00,45,1157,1202,37,6.968
2017-07-03 05:00:00+00:00,140,983,1123,43,7.54
2017-07-03 06:00:00+00:00,239,804,1043,45,8.189
2017-07-03 07:00:00+00:00,330,846,1176,45,9.203
2017-07-03 08:00:00+00:00,399,1053,1452,44,10.568
2017-07-03 09:00:00+00:00,493,1174,1667,43,11.724
2017-07-03 10:00:00+00:00,567,1240,1807,40,12.983
2017-07-03 11:00:00+00:00,579,1353,1932,39,13.886
2017-07-03 12:00:00+00:00,569,1463,2032,36,14.683
2017-07-03 13:00:00+00:00,519,1472,1991,35,14.673
2017-07-03 14:00:00+00:00,430,1379,1809,35,14.311
2017-07-03 15:00:00+00:00,332,1265,1597,39,13.831
2017-07-03 16:00:00+00:00,225,909,1134,41,13.272
2017-07-03 17:00:00+00:00,111,577,688,42,12.121
2017-07-03 18:00:00+00:00,34,384,418,42,10.29
2017-07-03 19:00:00+00:00,4,298,302,40,9.547
2017-07-03 20:00:00+00:00,0,183,183,40,9.074
2017-07-03 21:00:00+00:00,0,96,96,36,8.545
2017-07-03 22:00:00+00:00,0,88,88,30,8.125
2017-07-03 23:00:00+00:00,0,67,67,28,7.801
2017-07-04 00:00:00+00:00,0,84,84,26,7.664
2017-07-04 01:00:00+00:00,0,111,111,26,7.483
2017-07-04 02:00:00+00:00,0,180,180,26,7.209
2017-07-04 03:00:00+00:00,5,234,239,29,6.896
2017-07-04 04:00:00+00:00,46,202,248,36,7.864
2017-07-04 05:00:00+00:00,145,165,310,43,10.252
2017-07-04 06:00:00+00:00,275,153,428,43,11.915
2017-07-04 07:00:00+00:00,408,224,632,40,13.476
2017-07-04 08:00:00+00:00,515,343,858,37,14.985
2017-07-04 09:00:00+00:00,593,482,1075,35,16.281
2017-07-04 10:00:00+00:00,636,670,1306,32,17.347
2017-07-04 11:00:00+00:00,633,626,1259,32,18.117
2017-07-04 12:00:00+00:00,606,642,1248,31,18.433
2017-07-04 13:00:00+00:00,543,688,1231,32,18.34
2017-07-04 14:00:00+00:00,453,570,1023,34,17.835
2017-07-04 15:00:00+00:00,340,472,812,38,17.003
2017-07-04 16:00:00+00:00,227,308,535,42,16.218
2017-07-04 17:00:00+00:00,114,219,333,46,14.84
2017-07-04 18:00:00+00:00,35,164,199,45,13.117
2017-07-04 19:00:00+00:00,4,108,112,44,12.322
2017-07-04 20:00:00+00:00,0,68,68,44,11.823
2017-07-04 21:00:00+00:00,0,33,33,37,11.344
2017-07-04 22:00:00+00:00,0,15,15,35,10.958
2017-07-04 23:00:00+00:00,0,10,10,34,10.578
2017-07-05 00:00:00+00:00,0,9,9,32,10.162
2017-07-05 01:00:00+00:00,0,5,5,31,9.769
2017-07-05 02:00:00+00:00,0,4,4,31,9.471
2017-07-05 03:00:00+00:00,5,6,11,32,9.056
2017-07-05 04:00:00+00:00,51,5,56,39,10.144
2017-07-05 05:00:00+00:00,160,4,164,44,12.403
2017-07-05 06:00:00+00:00,292,4,296,47,14.647
2017-07-05 07:00:00+00:00,428,46,474,44,16.896
2017-07-05 08:00:00+00:00,538,92,630,41,18.413
2017-07-05 09:00:00+00:00,619,97,716,40,19.6
2017-07-05 10:00:00+00:00,657,66,723,38,20.427
2017-07-05 11:00:00+00:00,663,65,728,37,20.831
2017-07-05 12:00:00+00:00,624,80,704,36,20.82
2017-07-05 13:00:00+00:00,548,97,645,37,20.452
2017-07-05 14:00:00+00:00,448,100,548,36,19.791
2017-07-05 15:00:00+00:00,338,130,468,40,19.04
2017-07-05 16:00:00+00:00,231,500,731,44,18.406
2017-07-05 17:00:00+00:00,115,606,721,47,16.541
2017-07-05 18:00:00+00:00,32,758,790,45,15.558
2017-07-05 19:00:00+00:00,2,395,397,43,15.031
2017-07-05 20:00:00+00:00,0,316,316,43,14.428
2017-07-05 21:00:00+00:00,0,276,276,38,13.902
2017-07-05 22:00:00+00:00,0,198,198,34,13.467
2017-07-05 23:00:00+00:00,0,336,336,33,12.998
2017-07-06 00:00:00+00:00,0,571,571,32,12.579
2017-07-06 01:00:00+00:00,0,589,589,31,12.221
2017-07-06 02:00:00+00:00,0,374,374,31,11.887
2017-07-06 03:00:00+00:00,4,361,365,33,11.441
2017-07-06 04:00:00+00:00,48,346,394,38,12.039
2017-07-06 05:00:00+00:00,158,174,332,45,14.663
2017-07-06 06:00:00+00:00,292,104,396,46,16.76
2017-07-06 07:00:00+00:00,429,114,543,42,18.161
2017-07-06 08:00:00+00:00,540,114,654,41,19.415
2017-07-06 09:00:00+00:00,614,115,729,40,20.334
2017-07-06 10:00:00+00:00,652,121,773,38,20.907
2017-07-06 11:00:00+00:00,649,106,755,37,21.036
2017-07-06 12:00:00+00:00,613,94,707,36,20.825
2017-07-06 13:00:00+00:00,556,87,643,37,20.359
2017-07-06 14:00:00+00:00,462,46,508,39,19.79
2017-07-06 15:00:00+00:00,341,38,379,42,19.982
2017-07-06 16:00:00+00:00,227,40,267,46,19.781
2017-07-06 17:00:00+00:00,108,80,188,48,18.13
2017-07-06 18:00:00+00:00,28,144,172,46,17.087
2017-07-06 19:00:00+00:00,2,314,316,43,16.286
2017-07-06 20:00:00+00:00,0,552,552,42,15.483
2017-07-06 21:00:00+00:00,0,567,567,35,14.725
2017-07-06 22:00:00+00:00,0,547,547,32,14.048
2017-07-06 23:00:00+00:00,0,449,449,31,13.417
2017-07-07 00:00:00+00:00,0,410,410,30,12.906
2017-07-07 01:00:00+00:00,0,455,455,29,12.63
2017-07-07 02:00:00+00:00,0,562,562,30,12.571
2017-07-07 03:00:00+00:00,3,773,776,32,12.543
2017-07-07 04:00:00+00:00,44,694,738,37,12.999
2017-07-07 05:00:00+00:00,142,455,597,44,14.793
2017-07-07 06:00:00+00:00,264,297,561,48,16.89
2017-07-07 07:00:00+00:00,381,142,523,46,18.806
2017-07-07 08:00:00+00:00,480,130,610,44,19.545
2017-07-07 09:00:00+00:00,551,190,741,41,20.009
2017-07-07 10:00:00+00:00,586,121,707,37,20.33
2017-07-07 11:00:00+00:00,592,145,737,35,20.488
2017-07-07 12:00:00+00:00,549,192,741,33,20.239
2017-07-07 13:00:00+00:00,479,244,723,34,19.868
2017-07-07 14:00:00+00:00,401,289,690,35,18.892
2017-07-07 15:00:00+00:00,308,401,709,38,18.393
2017-07-07 16:00:00+00:00,205,626,831,41,18.136
2017-07-07 17:00:00+00:00,101,670,771,44,17.186
2017-07-07 18:00:00+00:00,28,734,762,44,15.813
2017-07-07 19:00:00+00:00,2,878,880,42,14.976
2017-07-07 20:00:00+00:00,0,567,567,41,14.48
2017-07-07 21:00:00+00:00,0,308,308,36,13.851
2017-07-07 22:00:00+00:00,0,419,419,36,13.165
2017-07-07 23:00:00+00:00,0,466,466,33,12.542
2017-07-08 00:00:00+00:00,0,160,160,31,12.036
2017-07-08 01:00:00+00:00,0,329,329,31,11.658
2017-07-08 02:00:00+00:00,0,786,786,30,11.243
2017-07-08 03:00:00+00:00,4,1001,1005,30,11.154
2017-07-08 04:00:00+00:00,43,742,785,31,12.539
2017-07-08 05:00:00+00:00,132,595,727,33,14.61
2017-07-08 06:00:00+00:00,251,617,868,35,16.095
2017-07-08 07:00:00+00:00,374,598,972,35,16.717
2017-07-08 08:00:00+00:00,468,493,961,35,18.095
2017-07-08 09:00:00+00:00,518,594,1112,34,19.13
2017-07-08 10:00:00+00:00,532,795,1327,32,19.874
2017-07-08 11:00:00+00:00,526,1023,1549,30,20.318
2017-07-08 12:00:00+00:00,512,1370,1882,29,20.396
2017-07-08 13:00:00+00:00,472,1143,1615,29,20.127
2017-07-08 14:00:00+00:00,411,564,975,30,19.473
2017-07-08 15:00:00+00:00,328,747,1075,33,18.824
2017-07-08 16:00:00+00:00,219,874,1093,36,18.405
2017-07-08 17:00:00+00:00,105,531,636,39,17.108
2017-07-08 18:00:00+00:00,29,399,428,39,15.768
2017-07-08 19:00:00+00:00,2,317,319,38,14.957
2017-07-08 20:00:00+00:00,0,205,205,41,14.334
2017-07-08 21:00:00+00:00,0,187,187,38,13.729
2017-07-08 22:00:00+00:00,0,156,156,34,13.308
2017-07-08 23:00:00+00:00,0,76,76,32,13.029
2017-07-09 00:00:00+00:00,0,40,40,31,12.788
2017-07-09 01:00:00+00:00,0,31,31,30,12.451
2017-07-09 02:00:00+00:00,0,29,29,30,12.036
2017-07-09 03:00:00+00:00,3,17,20,29,11.643
2017-07-09 04:00:00+00:00,35,15,50,29,12.378
2017-07-09 05:00:00+00:00,125,16,141,31,14.691
2017-07-09 06:00:00+00:00,237,10,247,31,15.739
2017-07-09 07:00:00+00:00,344,6,350,31,17.711
2017-07-09 08:00:00+00:00,420,19,439,29,18.804
2017-07-09 09:00:00+00:00,469,24,493,29,19.13
2017-07-09 10:00:00+00:00,508,44,552,28,19.166
2017-07-09 11:00:00+00:00,515,49,564,27,19.406
2017-07-09 12:00:00+00:00,485,133,618,25,19.527
2017-07-09 13:00:00+00:00,423,770,1193,25,19.249
2017-07-09 14:00:00+00:00,347,527,874,29,19.229
2017-07-09 15:00:00+00:00,272,223,495,31,18.729
2017-07-09 16:00:00+00:00,186,149,335,37,17.372
2017-07-09 17:00:00+00:00,87,133,220,40,15.817
2017-07-09 18:00:00+00:00,23,234,257,40,14.23
2017-07-09 19:00:00+00:00,2,279,281,40,13.362
2017-07-09 20:00:00+00:00,0,266,266,42,12.749
2017-07-09 21:00:00+00:00,0,962,962,38,12.299
2017-07-09 22:00:00+00:00,0,829,829,32,11.918
2017-07-09 23:00:00+00:00,0,665,665,30,11.918
2017-07-10 00:00:00+00:00,0,585,585,29,11.713
2017-07-10 01:00:00+00:00,0,338,338,28,11.496
2017-07-10 02:00:00+00:00,0,276,276,29,11.277
2017-07-10 03:00:00+00:00,3,292,295,30,11.128
2017-07-10 04:00:00+00:00,34,478,512,37,12.129
2017-07-10 05:00:00+00:00,114,473,587,43,13.314
2017-07-10 06:00:00+00:00,215,426,641,47,14.663
2017-07-10 07:00:00+00:00,324,233,557,45,16.488
2017-07-10 08:00:00+00:00,420,203,623,44,18.222
2017-07-10 09:00:00+00:00,499,273,772,43,19.306
2017-07-10 10:00:00+00:00,554,247,801,40,19.815
2017-07-10 11:00:00+00:00,569,298,867,40,19.666
2017-07-10 12:00:00+00:00,549,411,960,38,19.554
2017-07-10 13:00:00+00:00,487,526,1013,40,19.251
2017-07-10 14:00:00+00:00,389,658,1047,38,18.426
2017-07-10 15:00:00+00:00,297,489,786,42,17.654
2017-07-10 16:00:00+00:00,200,510,710,42,17.183
2017-07-10 17:00:00+00:00,98,899,997,44,16.144
2017-07-10 18:00:00+00:00,27,623,650,44,14.381
2017-07-10 19:00:00+00:00,2,310,312,41,13.103
2017-07-10 20:00:00+00:00,0,151,151,40,12.724
2017-07-10 21:00:00+00:00,0,128,128,34,12.153
2017-07-10 22:00:00+00:00,0,172,172,35,11.797
2017-07-10 23:00:00+00:00,0,316,316,32,11.557
2017-07-11 00:00:00+00:00,0,903,903,31,11.357
2017-07-11 01:00:00+00:00,0,988,988,30,11.184
2017-07-11 02:00:00+00:00,0,1207,1207,30,11.004
2017-07-11 03:00:00+00:00,2,1491,1493,31,10.691
2017-07-11 04:00:00+00:00,26,1598,1624,38,11.242
2017-07-11 05:00:00+00:00,99,1330,1429,44,12.071
2017-07-11 06:00:00+00:00,174,1031,1205,46,12.912
2017-07-11 07:00:00+00:00,258,799,1057,46,14.057
2017-07-11 08:00:00+00:00,333,811,1144,44,15.56
2017-07-11 09:00:00+00:00,414,984,1398,43,16.62
2017-07-11 10:00:00+00:00,500,1120,1620,39,17.352
2017-07-11 11:00:00+00:00,535,900,1435,36,17.484
2017-07-11 12:00:00+00:00,521,1259,1780,35,17.025
2017-07-11 13:00:00+00:00,476,1187,1663,36,15.792
2017-07-11 14:00:00+00:00,389,867,1256,35,14.982
2017-07-11 15:00:00+00:00,271,515,786,38,14.541
2017-07-11 16:00:00+00:00,166,337,503,42,14.191
2017-07-11 17:00:00+00:00,76,224,300,44,13.44
2017-07-11 18:00:00+00:00,20,272,292,42,12.612
2017-07-11 19:00:00+00:00,2,312,314,41,12.19
2017-07-11 20:00:00+00:00,0,196,196,41,11.851
2017-07-11 21:00:00+00:00,0,276,276,35,11.416
2017-07-11 22:00:00+00:00,0,333,333,33,10.869
2017-07-11 23:00:00+00:00,0,167,167,30,10.337
2017-07-12 00:00:00+00:00,0,131,131,30,9.861
2017-07-12 01:00:00+00:00,0,190,190,29,9.482
2017-07-12 02:00:00+00:00,0,144,144,29,9.12
2017-07-12 03:00:00+00:00,2,77,79,31,8.797
2017-07-12 04:00:00+00:00,33,79,112,36,10.142
2017-07-12 05:00:00+00:00,113,39,152,43,12.317
2017-07-12 06:00:00+00:00,208,11,219,45,15.5
2017-07-12 07:00:00+00:00,300,14,314,45,16.708
2017-07-12 08:00:00+00:00,374,26,400,44,17.611
2017-07-12 09:00:00+00:00,439,86,525,44,18.671
2017-07-12 10:00:00+00:00,481,182,663,43,19.331
2017-07-12 11:00:00+00:00,519,234,753,40,19.354
2017-07-12 12:00:00+00:00,502,248,750,37,18.885
2017-07-12 13:00:00+00:00,452,274,726,36,18.244
2017-07-12 14:00:00+00:00,387,180,567,34,17.29
2017-07-12 15:00:00+00:00,298,306,604,34,16.509
2017-07-12 16:00:00+00:00,199,121,320,35,15.539
2017-07-12 17:00:00+00:00,93,168,261,36,14.626
2017-07-12 18:00:00+00:00,24,371,395,34,13.731
2017-07-12 19:00:00+00:00,2,739,741,32,12.966
2017-07-12 20:00:00+00:00,0,824,824,29,11.894
2017-07-12 21:00:00+00:00,0,1222,1222,24,11.035
2017-07-12 22:00:00+00:00,0,1502,1502,24,10.617
2017-07-12 23:00:00+00:00,0,1800,1800,23,10.444
2017-07-13 00:00:00+00:00,0,2079,2079,21,9.782
2017-07-13 01:00:00+00:00,0,2242,2242,21,8.792
2017-07-13 02:00:00+00:00,0,2045,2045,23,7.957
2017-07-13 03:00:00+00:00,3,2003,2006,26,7.233
2017-07-13 04:00:00+00:00,43,1952,1995,32,7.378
2017-07-13 05:00:00+00:00,143,1871,2014,38,8.072
2017-07-13 06:00:00+00:00,261,2080,2341,40,9.473
2017-07-13 07:00:00+00:00,365,1974,2339,38,11.437
2017-07-13 08:00:00+00:00,473,1982,2455,36,13.239
2017-07-13 09:00:00+00:00,573,2029,2602,35,14.651
2017-07-13 10:00:00+00:00,630,1850,2480,32,15.769
2017-07-13 11:00:00+00:00,647,1670,2317,31,16.503
2017-07-13 12:00:00+00:00,631,1566,2197,30,16.906
2017-07-13 13:00:00+00:00,586,1424,2010,31,16.887
2017-07-13 14:00:00+00:00,500,1277,1777,32,16.466
2017-07-13 15:00:00+00:00,381,1104,1485,37,15.738
2017-07-13 16:00:00+00:00,251,914,1165,40,14.508
2017-07-13 17:00:00+00:00,123,707,830,44,12.966
2017-07-13 18:00:00+00:00,36,584,620,43,10.928
2017-07-13 19:00:00+00:00,4,611,615,43,9.769
2017-07-13 20:00:00+00:00,0,610,610,44,9.302
2017-07-13 21:00:00+00:00,0,451,451,37,8.882
2017-07-13 22:00:00+00:00,0,262,262,34,8.656
2017-07-13 23:00:00+00:00,0,166,166,32,8.567
2017-07-14 00:00:00+00:00,0,129,129,31,8.489
2017-07-14 01:00:00+00:00,0,72,72,30,8.343
2017-07-14 02:00:00+00:00,0,29,29,30,8.258
2017-07-14 03:00:00+00:00,3,22,25,31,8.214
2017-07-14 04:00:00+00:00,34,19,53,38,8.68
2017-07-14 05:00:00+00:00,114,15,129,43,10.604
2017-07-14 06:00:00+00:00,218,9,227,43,10.955
2017-07-14 07:00:00+00:00,327,17,344,42,10.557
2017-07-14 08:00:00+00:00,409,26,435,41,10.804
2017-07-14 09:00:00+00:00,484,27,511,41,12.029
2017-07-14 10:00:00+00:00,535,35,570,37,14.197
2017-07-14 11:00:00+00:00,542,57,599,34,15.609
2017-07-14 12:00:00+00:00,540,60,600,33,15.743
2017-07-14 13:00:00+00:00,491,68,559,32,14.896
2017-07-14 14:00:00+00:00,407,68,475,33,13.579
2017-07-14 15:00:00+00:00,297,52,349,35,12.232
2017-07-14 16:00:00+00:00,191,52,243,37,11.106
2017-07-14 17:00:00+00:00,93,110,203,39,10.328
2017-07-14 18:00:00+00:00,28,118,146,38,9.126
2017-07-14 19:00:00+00:00,3,155,158,38,7.981
2017-07-14 20:00:00+00:00,0,312,312,37,7.672
2017-07-14 21:00:00+00:00,0,617,617,33,7.618
2017-07-14 22:00:00+00:00,0,880,880,34,7.495
2017-07-14 23:00:00+00:00,0,1590,1590,32,7.401
2017-07-15 00:00:00+00:00,0,1738,1738,31,7.249
2017-07-15 01:00:00+00:00,0,1498,1498,30,6.987
2017-07-15 02:00:00+00:00,0,1174,1174,30,6.757
2017-07-15 03:00:00+00:00,3,875,878,29,6.424
2017-07-15 04:00:00+00:00,32,874,906,29,6.796
2017-07-15 05:00:00+00:00,102,988,1090,31,7.237
2017-07-15 06:00:00+00:00,181,1154,1335,33,7.686
2017-07-15 07:00:00+00:00,244,1043,1287,35,8.45
2017-07-15 08:00:00+00:00,302,1055,1357,35,9.187
2017-07-15 09:00:00+00:00,339,1201,1540,35,9.969
2017-07-15 10:00:00+00:00,415,1180,1595,33,10.912
2017-07-15 11:00:00+00:00,467,1015,1482,32,11.607
2017-07-15 12:00:00+00:00,474,1138,1612,31,11.892
2017-07-15 13:00:00+00:00,454,1241,1695,32,11.844
2017-07-15 14:00:00+00:00,388,1305,1693,32,11.507
2017-07-15 15:00:00+00:00,292,1471,1763,33,10.923
2017-07-15 16:00:00+00:00,203,1077,1280,38,10.012
2017-07-15 17:00:00+00:00,108,737,845,40,8.676
2017-07-15 18:00:00+00:00,33,992,1025,40,6.772
2017-07-15 19:00:00+00:00,3,1340,1343,39,5.699
2017-07-15 20:00:00+00:00,0,1356,1356,40,5.534
2017-07-15 21:00:00+00:00,0,1371,1371,36,5.425
2017-07-15 22:00:00+00:00,0,1328,1328,32,5.212
2017-07-15 23:00:00+00:00,0,1327,1327,29,4.985
2017-07-16 00:00:00+00:00,0,1359,1359,28,4.931
2017-07-16 01:00:00+00:00,0,1428,1428,27,4.858
2017-07-16 02:00:00+00:00,0,1306,1306,27,4.746
2017-07-16 03:00:00+00:00,3,1034,1037,27,4.458
2017-07-16 04:00:00+00:00,41,872,913,26,5.566
2017-07-16 05:00:00+00:00,138,575,713,26,6.791
2017-07-16 06:00:00+00:00,265,421,686,27,7.878
2017-07-16 07:00:00+00:00,392,345,737,28,9.557
2017-07-16 08:00:00+00:00,465,356,821,29,11.321
2017-07-16 09:00:00+00:00,509,420,929,30,12.584
2017-07-16 10:00:00+00:00,535,500,1035,29,13.49
2017-07-16 11:00:00+00:00,527,526,1053,29,14.002
2017-07-16 12:00:00+00:00,495,474,969,28,14.24
2017-07-16 13:00:00+00:00,428,405,833,28,14.278
2017-07-16 14:00:00+00:00,366,393,759,28,14.058
2017-07-16 15:00:00+00:00,297,340,637,29,13.583
2017-07-16 16:00:00+00:00,206,281,487,32,12.758
2017-07-16 17:00:00+00:00,104,232,336,37,11.452
2017-07-16 18:00:00+00:00,31,211,242,37,9.282
2017-07-16 19:00:00+00:00,3,238,241,38,8.677
2017-07-16 20:00:00+00:00,0,208,208,39,8.354
2017-07-16 21:00:00+00:00,0,125,125,36,7.835
2017-07-16 22:00:00+00:00,0,96,96,31,7.363
2017-07-16 23:00:00+00:00,0,51,51,29,7.005
2017-07-17 00:00:00+00:00,0,37,37,29,6.708
2017-07-17 01:00:00+00:00,0,36,36,27,6.446
2017-07-17 02:00:00+00:00,0,53,53,28,6.233
2017-07-17 03:00:00+00:00,3,85,88,29,5.897
2017-07-17 04:00:00+00:00,39,99,138,37,6.704
2017-07-17 05:00:00+00:00,138,67,205,44,9.391
2017-07-17 06:00:00+00:00,258,27,285,44,11.923
2017-07-17 07:00:00+00:00,375,17,392,44,13.983
2017-07-17 08:00:00+00:00,472,15,487,43,15.739
2017-07-17 09:00:00+00:00,540,19,559,42,17.121
2017-07-17 10:00:00+00:00,585,32,617,40,18.221
2017-07-17 11:00:00+00:00,595,36,631,40,19.013
2017-07-17 12:00:00+00:00,562,41,603,37,19.368
2017-07-17 13:00:00+00:00,508,24,532,37,19.192
2017-07-17 14:00:00+00:00,433,19,452,36,18.713
2017-07-17 15:00:00+00:00,333,14,347,40,17.836
2017-07-17 16:00:00+00:00,221,8,229,43,17.141
2017-07-17 17:00:00+00:00,106,9,115,46,15.681
2017-07-17 18:00:00+00:00,28,14,42,44,13.673
2017-07-17 19:00:00+00:00,2,15,17,43,12.934
2017-07-17 20:00:00+00:00,0,51,51,42,12.462
2017-07-17 21:00:00+00:00,0,99,99,36,11.878
2017-07-17 22:00:00+00:00,0,132,132,34,11.291
2017-07-17 23:00:00+00:00,0,105,105,33,10.823
2017-07-18 00:00:00+00:00,0,92,92,32,10.395
2017-07-18 01:00:00+00:00,0,117,117,31,9.975
2017-07-18 02:00:00+00:00,0,50,50,31,9.557
2017-07-18 03:00:00+00:00,2,34,36,32,9.09
2017-07-18 04:00:00+00:00,37,45,82,40,10.024
2017-07-18 05:00:00+00:00,133,39,172,45,12.327
2017-07-18 06:00:00+00:00,260,31,291,44,14.543
2017-07-18 07:00:00+00:00,397,53,450,42,16.654
2017-07-18 08:00:00+00:00,513,79,592,40,18.201
2017-07-18 09:00:00+00:00,597,157,754,40,19.107
2017-07-18 10:00:00+00:00,643,242,885,37,19.462
2017-07-18 11:00:00+00:00,641,287,928,36,19.625
2017-07-18 12:00:00+00:00,608,307,915,35,19.301
2017-07-18 13:00:00+00:00,552,334,886,36,18.802
2017-07-18 14:00:00+00:00,464,385,849,36,18.118
2017-07-18 15:00:00+00:00,347,426,773,41,17.454
2017-07-18 16:00:00+00:00,227,486,713,44,15.989
2017-07-18 17:00:00+00:00,105,508,613,46,14.805
2017-07-18 18:00:00+00:00,26,624,650,45,13.582
2017-07-18 19:00:00+00:00,1,979,980,41,12.791
2017-07-18 20:00:00+00:00,0,1207,1207,40,12.218
2017-07-18 21:00:00+00:00,0,1194,1194,34,11.992
2017-07-18 22:00:00+00:00,0,1209,1209,33,11.835
2017-07-18 23:00:00+00:00,0,1181,1181,31,11.552
2017-07-19 00:00:00+00:00,0,1071,1071,29,10.97
2017-07-19 01:00:00+00:00,0,922,922,29,10.438
2017-07-19 02:00:00+00:00,0,820,820,29,10.044
2017-07-19 03:00:00+00:00,1,793,794,30,9.567
2017-07-19 04:00:00+00:00,27,795,822,35,10.418
2017-07-19 05:00:00+00:00,105,588,693,40,13.043
2017-07-19 06:00:00+00:00,207,457,664,42,15.279
2017-07-19 07:00:00+00:00,311,531,842,40,17.673
2017-07-19 08:00:00+00:00,392,724,1116,38,18.842
2017-07-19 09:00:00+00:00,456,811,1267,37,19.61
2017-07-19 10:00:00+00:00,507,787,1294,33,19.867
2017-07-19 11:00:00+00:00,529,690,1219,32,19.758
2017-07-19 12:00:00+00:00,527,541,1068,32,19.573
2017-07-19 13:00:00+00:00,490,423,913,33,19.264
2017-07-19 14:00:00+00:00,406,370,776,35,18.939
2017-07-19 15:00:00+00:00,301,755,1056,40,18.97
2017-07-19 16:00:00+00:00,205,254,459,42,19.207
2017-07-19 17:00:00+00:00,99,82,181,44,17.46
2017-07-19 18:00:00+00:00,25,43,68,41,15.596
2017-07-19 19:00:00+00:00,1,81,82,40,14.226
2017-07-19 20:00:00+00:00,0,55,55,38,13.25
2017-07-19 21:00:00+00:00,0,48,48,32,12.522
2017-07-19 22:00:00+00:00,0,34,34,31,12.046
2017-07-19 23:00:00+00:00,0,36,36,29,11.758
2017-07-20 00:00:00+00:00,0,33,33,29,11.677
2017-07-20 01:00:00+00:00,0,49,49,29,11.472
2017-07-20 02:00:00+00:00,0,45,45,29,11.69
2017-07-20 03:00:00+00:00,2,57,59,31,12.388
2017-07-20 04:00:00+00:00,35,63,98,37,13.101
2017-07-20 05:00:00+00:00,128,115,243,43,15.122
2017-07-20 06:00:00+00:00,249,54,303,45,18.339
2017-07-20 07:00:00+00:00,379,29,408,45,19.512
2017-07-20 08:00:00+00:00,490,31,521,45,19.985
2017-07-20 09:00:00+00:00,571,36,607,45,20.169
2017-07-20 10:00:00+00:00,606,32,638,41,20.395
2017-07-20 11:00:00+00:00,599,34,633,39,19.822
2017-07-20 12:00:00+00:00,559,33,592,38,19.465
2017-07-20 13:00:00+00:00,497,21,518,38,18.087
2017-07-20 14:00:00+00:00,410,48,458,38,17.254
2017-07-20 15:00:00+00:00,297,70,367,41,16.235
2017-07-20 16:00:00+00:00,185,86,271,43,15.129
2017-07-20 17:00:00+00:00,78,121,199,45,14.191
2017-07-20 18:00:00+00:00,18,237,255,44,13.124
2017-07-20 19:00:00+00:00,1,758,759,42,12.285
2017-07-20 20:00:00+00:00,0,1919,1919,41,11.729
2017-07-20 21:00:00+00:00,0,2153,2153,36,11.41
2017-07-20 22:00:00+00:00,0,1831,1831,31,10.987
2017-07-20 23:00:00+00:00,0,1382,1382,29,10.838
2017-07-21 00:00:00+00:00,0,1535,1535,28,10.854
2017-07-21 01:00:00+00:00,0,1497,1497,27,10.876
2017-07-21 02:00:00+00:00,0,1125,1125,28,10.883
2017-07-21 03:00:00+00:00,1,780,781,30,10.653
2017-07-21 04:00:00+00:00,26,594,620,35,10.997
2017-07-21 05:00:00+00:00,97,430,527,42,14.119
2017-07-21 06:00:00+00:00,196,328,524,43,18.607
2017-07-21 07:00:00+00:00,314,324,638,42,20.887
2017-07-21 08:00:00+00:00,423,293,716,40,19.85
2017-07-21 09:00:00+00:00,514,226,740,39,19.275
2017-07-21 10:00:00+00:00,560,174,734,36,19.695
2017-07-21 11:00:00+00:00,565,155,720,35,19.782
2017-07-21 12:00:00+00:00,567,107,674,34,19.538
2017-07-21 13:00:00+00:00,523,67,590,35,19.185
2017-07-21 14:00:00+00:00,444,56,500,36,18.721
2017-07-21 15:00:00+00:00,339,48,387,40,18.323
2017-07-21 16:00:00+00:00,218,42,260,43,16.87
2017-07-21 17:00:00+00:00,96,63,159,44,15.162
2017-07-21 18:00:00+00:00,23,112,135,43,13.466
2017-07-21 19:00:00+00:00,1,163,164,42,12.684
2017-07-21 20:00:00+00:00,0,245,245,40,12.241
2017-07-21 21:00:00+00:00,0,312,312,35,11.699
2017-07-21 22:00:00+00:00,0,302,302,34,11.307
2017-07-21 23:00:00+00:00,0,412,412,31,10.842
2017-07-22 00:00:00+00:00,0,433,433,30,10.373
2017-07-22 01:00:00+00:00,0,397,397,29,10.047
2017-07-22 02:00:00+00:00,0,451,451,29,9.877
2017-07-22 03:00:00+00:00,1,506,507,29,9.766
2017-07-22 04:00:00+00:00,26,467,493,29,11.013
2017-07-22 05:00:00+00:00,100,305,405,31,13.495
2017-07-22 06:00:00+00:00,193,311,504,34,14.994
2017-07-22 07:00:00+00:00,292,228,520,35,16.356
2017-07-22 08:00:00+00:00,379,234,613,34,17.425
2017-07-22 09:00:00+00:00,454,233,687,33,18.1
2017-07-22 10:00:00+00:00,501,164,665,31,18.503
2017-07-22 11:00:00+00:00,511,134,645,30,18.691
2017-07-22 12:00:00+00:00,492,138,630,29,18.65
2017-07-22 13:00:00+00:00,452,209,661,28,18.385
2017-07-22 14:00:00+00:00,396,338,734,29,18.068
2017-07-22 15:00:00+00:00,311,315,626,33,17.632
2017-07-22 16:00:00+00:00,206,264,470,36,17.237
2017-07-22 17:00:00+00:00,94,134,228,38,16.155
2017-07-22 18:00:00+00:00,23,90,113,38,14.557
2017-07-22 19:00:00+00:00,1,63,64,38,13.787
2017-07-22 20:00:00+00:00,0,42,42,38,13.189
2017-07-22 21:00:00+00:00,0,50,50,34,12.79
2017-07-22 22:00:00+00:00,0,101,101,31,12.692
2017-07-22 23:00:00+00:00,0,151,151,28,12.651
2017-07-23 00:00:00+00:00,0,132,132,26,12.535
2017-07-23 01:00:00+00:00,0,60,60,26,12.138
2017-07-23 02:00:00+00:00,0,171,171,26,11.85
2017-07-23 03:00:00+00:00,1,65,66,25,11.504
2017-07-23 04:00:00+00:00,22,35,57,25,11.597
2017-07-23 05:00:00+00:00,83,52,135,27,12.381
2017-07-23 06:00:00+00:00,166,115,281,28,13.646
2017-07-23 07:00:00+00:00,263,433,696,28,15.101
2017-07-23 08:00:00+00:00,348,680,1028,27,17.33
2017-07-23 09:00:00+00:00,414,539,953,27,18.946
2017-07-23 10:00:00+00:00,446,768,1214,25,18.487
2017-07-23 11:00:00+00:00,472,978,1450,19,18.245
2017-07-23 12:00:00+00:00,471,852,1323,14,17.952
2017-07-23 13:00:00+00:00,422,570,992,16,17.106
2017-07-23 14:00:00+00:00,348,389,737,20,16.521
2017-07-23 15:00:00+00:00,244,262,506,26,16.172
2017-07-23 16:00:00+00:00,150,150,300,31,15.264
2017-07-23 17:00:00+00:00,70,124,194,36,14.554
2017-07-23 18:00:00+00:00,17,178,195,37,13.71
2017-07-23 19:00:00+00:00,0,197,197,37,13.214
2017-07-23 20:00:00+00:00,0,159,159,39,12.812
2017-07-23 21:00:00+00:00,0,68,68,36,12.458
2017-07-23 22:00:00+00:00,0,45,45,30,12.155
2017-07-23 23:00:00+00:00,0,75,75,29,11.946
2017-07-24 00:00:00+00:00,0,159,159,28,11.823
2017-07-24 01:00:00+00:00,0,217,217,26,11.662
2017-07-24 02:00:00+00:00,0,270,270,27,11.334
2017-07-24 03:00:00+00:00,1,277,278,29,10.959
2017-07-24 04:00:00+00:00,25,242,267,37,11.292
2017-07-24 05:00:00+00:00,84,215,299,43,11.956
2017-07-24 06:00:00+00:00,149,183,332,43,12.385
2017-07-24 07:00:00+00:00,222,147,369,43,12.853
2017-07-24 08:00:00+00:00,278,101,379,44,13.483
2017-07-24 09:00:00+00:00,325,85,410,45,13.826
2017-07-24 10:00:00+00:00,330,207,537,42,13.79
2017-07-24 11:00:00+00:00,334,206,540,41,13.552
2017-07-24 12:00:00+00:00,322,174,496,39,12.86
2017-07-24 13:00:00+00:00,283,99,382,40,12.13
2017-07-24 14:00:00+00:00,245,167,412,40,11.49
2017-07-24 15:00:00+00:00,178,556,734,41,10.889
2017-07-24 16:00:00+00:00,115,1263,1378,43,10.268
2017-07-24 17:00:00+00:00,52,1203,1255,43,9.482
2017-07-24 18:00:00+00:00,13,1310,1323,43,8.55
2017-07-24 19:00:00+00:00,0,1798,1798,42,7.747
2017-07-24 20:00:00+00:00,0,2130,2130,41,7.203
2017-07-24 21:00:00+00:00,0,2234,2234,35,6.776
2017-07-24 22:00:00+00:00,0,2349,2349,30,6.525
2017-07-24 23:00:00+00:00,0,2285,2285,29,6.299
2017-07-25 00:00:00+00:00,0,2139,2139,27,6.194
2017-07-25 01:00:00+00:00,0,2047,2047,26,6.146
2017-07-25 02:00:00+00:00,0,1910,1910,27,5.952
2017-07-25 03:00:00+00:00,1,1834,1835,29,5.7
2017-07-25 04:00:00+00:00,29,1959,1988,34,6.144
2017-07-25 05:00:00+00:00,115,1908,2023,40,6.872
2017-07-25 06:00:00+00:00,219,2120,2339,41,7.807
2017-07-25 07:00:00+00:00,327,2226,2553,42,8.969
2017-07-25 08:00:00+00:00,427,2133,2560,42,10.241
2017-07-25 09:00:00+00:00,510,1987,2497,43,11.552
2017-07-25 10:00:00+00:00,566,1839,2405,40,12.524
2017-07-25 11:00:00+00:00,553,1705,2258,40,12.943
2017-07-25 12:00:00+00:00,530,1742,2272,38,12.886
2017-07-25 13:00:00+00:00,476,1729,2205,37,12.499
2017-07-25 14:00:00+00:00,390,1625,2015,36,11.655
2017-07-25 15:00:00+00:00,299,1489,1788,38,10.599
2017-07-25 16:00:00+00:00,189,1681,1870,38,9.627
2017-07-25 17:00:00+00:00,88,1839,1927,39,8.617
2017-07-25 18:00:00+00:00,25,1762,1787,37,7.12
2017-07-25 19:00:00+00:00,1,1444,1445,35,6.338
2017-07-25 20:00:00+00:00,0,1369,1369,35,5.968
2017-07-25 21:00:00+00:00,0,1527,1527,30,5.538
2017-07-25 22:00:00+00:00,0,1542,1542,26,5.142
2017-07-25 23:00:00+00:00,0,1381,1381,24,4.845
2017-07-26 00:00:00+00:00,0,1149,1149,23,4.652
2017-07-26 01:00:00+00:00,0,844,844,22,4.504
2017-07-26 02:00:00+00:00,0,657,657,23,4.581
2017-07-26 03:00:00+00:00,1,511,512,24,4.689
2017-07-26 04:00:00+00:00,20,473,493,31,5.149
2017-07-26 05:00:00+00:00,83,454,537,38,5.635
2017-07-26 06:00:00+00:00,161,511,672,39,6.424
2017-07-26 07:00:00+00:00,244,688,932,40,7.749
2017-07-26 08:00:00+00:00,302,482,784,40,9.096
2017-07-26 09:00:00+00:00,343,370,713,40,10.148
2017-07-26 10:00:00+00:00,361,439,800,39,10.218
2017-07-26 11:00:00+00:00,365,579,944,37,9.503
2017-07-26 12:00:00+00:00,351,956,1307,36,9.16
2017-07-26 13:00:00+00:00,318,1197,1515,36,9.438
2017-07-26 14:00:00+00:00,264,1454,1718,35,9.523
2017-07-26 15:00:00+00:00,190,1549,1739,38,9.1
2017-07-26 16:00:00+00:00,132,1342,1474,39,8.324
2017-07-26 17:00:00+00:00,68,1057,1125,40,7.245
2017-07-26 18:00:00+00:00,18,963,981,39,6.202
2017-07-26 19:00:00+00:00,1,824,825,37,5.917
2017-07-26 20:00:00+00:00,0,911,911,36,5.95
2017-07-26 21:00:00+00:00,0,1237,1237,33,6.084
2017-07-26 22:00:00+00:00,0,1458,1458,28,6.108
2017-07-26 23:00:00+00:00,0,1418,1418,27,6.014
2017-07-27 00:00:00+00:00,0,1381,1381,25,5.967
2017-07-27 01:00:00+00:00,0,1406,1406,24,6.004
2017-07-27 02:00:00+00:00,0,1544,1544,24,6.106
2017-07-27 03:00:00+00:00,1,1525,1526,26,6.239
2017-07-27 04:00:00+00:00,22,1515,1537,32,6.76
2017-07-27 05:00:00+00:00,90,1341,1431,38,7.751
2017-07-27 06:00:00+00:00,178,1284,1462,39,8.99
2017-07-27 07:00:00+00:00,274,1318,1592,39,10.627
2017-07-27 08:00:00+00:00,360,1230,1590,40,12.557
2017-07-27 09:00:00+00:00,419,1293,1712,39,14.028
2017-07-27 10:00:00+00:00,454,1247,1701,38,14.451
2017-07-27 11:00:00+00:00,441,1066,1507,36,14.415
2017-07-27 12:00:00+00:00,417,650,1067,35,14.321
2017-07-27 13:00:00+00:00,375,436,811,34,13.725
2017-07-27 14:00:00+00:00,320,262,582,34,13.622
2017-07-27 15:00:00+00:00,249,226,475,35,13.278
2017-07-27 16:00:00+00:00,163,173,336,37,12.616
2017-07-27 17:00:00+00:00,76,116,192,38,11.745
2017-07-27 18:00:00+00:00,19,154,173,38,10.872
2017-07-27 19:00:00+00:00,0,320,320,36,10.464
2017-07-27 20:00:00+00:00,0,552,552,36,10.11
2017-07-27 21:00:00+00:00,0,669,669,31,9.847
2017-07-27 22:00:00+00:00,0,498,498,29,9.51
2017-07-27 23:00:00+00:00,0,360,360,28,9.45
2017-07-28 00:00:00+00:00,0,331,331,27,9.348
2017-07-28 01:00:00+00:00,0,329,329,26,8.895
2017-07-28 02:00:00+00:00,0,292,292,26,8.433
2017-07-28 03:00:00+00:00,1,249,250,27,8.336
2017-07-28 04:00:00+00:00,23,197,220,31,8.913
2017-07-28 05:00:00+00:00,95,243,338,36,11.171
2017-07-28 06:00:00+00:00,198,282,480,37,13.088
2017-07-28 07:00:00+00:00,321,463,784,36,14.208
2017-07-28 08:00:00+00:00,425,670,1095,34,15.148
2017-07-28 09:00:00+00:00,499,760,1259,31,15.922
2017-07-28 10:00:00+00:00,536,1278,1814,29,16.471
2017-07-28 11:00:00+00:00,529,1712,2241,27,16.336
2017-07-28 12:00:00+00:00,489,1910,2399,25,15.682
2017-07-28 13:00:00+00:00,439,1861,2300,26,14.942
2017-07-28 14:00:00+00:00,371,2055,2426,27,14.253
2017-07-28 15:00:00+00:00,268,2068,2336,29,13.5
2017-07-28 16:00:00+00:00,177,1896,2073,32,12.888
2017-07-28 17:00:00+00:00,86,1781,1867,34,12.141
2017-07-28 18:00:00+00:00,21,1691,1712,35,11.115
2017-07-28 19:00:00+00:00,1,1593,1594,35,10.306
2017-07-28 20:00:00+00:00,0,1538,1538,34,9.777
2017-07-28 21:00:00+00:00,0,1473,1473,31,9.455
2017-07-28 22:00:00+00:00,0,1294,1294,28,9.114
2017-07-28 23:00:00+00:00,0,1066,1066,26,8.757
2017-07-29 00:00:00+00:00,0,857,857,24,8.447
2017-07-29 01:00:00+00:00,0,683,683,23,8.214
2017-07-29 02:00:00+00:00,0,526,526,22,8.08
2017-07-29 03:00:00+00:00,1,329,330,21,7.799
2017-07-29 04:00:00+00:00,24,219,243,19,8.613
2017-07-29 05:00:00+00:00,104,111,215,21,10.868
2017-07-29 06:00:00+00:00,221,39,260,21,13.238
2017-07-29 07:00:00+00:00,358,23,381,22,15.742
2017-07-29 08:00:00+00:00,487,10,497,20,17.604
2017-07-29 09:00:00+00:00,591,14,605,15,18.93
2017-07-29 10:00:00+00:00,646,26,672,9,19.824
2017-07-29 11:00:00+00:00,650,50,700,7,20.425
2017-07-29 12:00:00+00:00,625,52,677,10,20.38
2017-07-29 13:00:00+00:00,558,61,619,13,19.71
2017-07-29 14:00:00+00:00,449,59,508,18,19.079
2017-07-29 15:00:00+00:00,321,61,382,25,18.041
2017-07-29 16:00:00+00:00,199,71,270,30,16.714
2017-07-29 17:00:00+00:00,84,100,184,34,15.447
2017-07-29 18:00:00+00:00,18,186,204,36,14.112
2017-07-29 19:00:00+00:00,1,323,324,36,13.329
2017-07-29 20:00:00+00:00,0,437,437,36,12.684
2017-07-29 21:00:00+00:00,0,567,567,34,12.103
2017-07-29 22:00:00+00:00,0,592,592,29,11.6
2017-07-29 23:00:00+00:00,0,563,563,25,11.226
2017-07-30 00:00:00+00:00,0,507,507,22,10.871
2017-07-30 01:00:00+00:00,0,600,600,20,10.534
2017-07-30 02:00:00+00:00,0,728,728,18,10.261
2017-07-30 03:00:00+00:00,0,694,694,16,9.965
2017-07-30 04:00:00+00:00,22,687,709,13,10.892
2017-07-30 05:00:00+00:00,97,612,709,14,12.896
2017-07-30 06:00:00+00:00,200,623,823,10,14.706
2017-07-30 07:00:00+00:00,312,733,1045,11,16.881
2017-07-30 08:00:00+00:00,417,1055,1472,7,18.332
2017-07-30 09:00:00+00:00,504,1179,1683,5,18.776
2017-07-30 10:00:00+00:00,557,1142,1699,1,18.52
2017-07-30 11:00:00+00:00,573,1101,1674,-9,18.345
2017-07-30 12:00:00+00:00,554,993,1547,-10,18.134
2017-07-30 13:00:00+00:00,500,691,1191,-2,17.97
2017-07-30 14:00:00+00:00,416,580,996,8,17.836
2017-07-30 15:00:00+00:00,307,567,874,19,17.842
2017-07-30 16:00:00+00:00,192,626,818,26,17.807
2017-07-30 17:00:00+00:00,81,659,740,33,16.323
2017-07-30 18:00:00+00:00,17,677,694,35,14.75
2017-07-30 19:00:00+00:00,0,427,427,36,13.793
2017-07-30 20:00:00+00:00,0,250,250,36,13.128
2017-07-30 21:00:00+00:00,0,191,191,33,12.678
2017-07-30 22:00:00+00:00,0,87,87,28,12.296
2017-07-30 23:00:00+00:00,0,105,105,26,11.911
2017-07-31 00:00:00+00:00,0,160,160,24,11.517
2017-07-31 01:00:00+00:00,0,142,142,23,11.134
2017-07-31 02:00:00+00:00,0,112,112,24,10.743
2017-07-31 03:00:00+00:00,0,98,98,26,10.455
2017-07-31 04:00:00+00:00,23,162,185,34,11.169
2017-07-31 05:00:00+00:00,108,102,210,38,13.977
2017-07-31 06:00:00+00:00,229,56,285,38,15.768
2017-07-31 07:00:00+00:00,361,28,389,35,18.725
2017-07-31 08:00:00+00:00,482,11,493,32,20.656
2017-07-31 09:00:00+00:00,558,23,581,31,21.799
2017-07-31 10:00:00+00:00,603,53,656,29,22.524
2017-07-31 11:00:00+00:00,625,65,690,28,22.812
2017-07-31 12:00:00+00:00,602,68,670,28,22.724
2017-07-31 13:00:00+00:00,539,66,605,30,22.368
2017-07-31 14:00:00+00:00,446,71,517,32,21.869
2017-07-31 15:00:00+00:00,330,92,422,36,22.711
2017-07-31 16:00:00+00:00,203,142,345,40,20.987
2017-07-31 17:00:00+00:00,81,192,273,43,18.355
2017-07-31 18:00:00+00:00,16,297,313,42,15.888
2017-07-31 19:00:00+00:00,0,553,553,40,14.69
2017-07-31 20:00:00+00:00,0,824,824,39,13.996
2017-07-31 21:00:00+00:00,0,940,940,33,13.392
2017-07-31 22:00:00+00:00,0,834,834,32,12.86
2017-07-31 23:00:00+00:00,0,934,934,30,12.382
2017-08-01 00:00:00+00:00,0,1090,1090,29,12.027
2017-08-01 01:00:00+00:00,0,1028,1028,29,11.764
2017-08-01 02:00:00+00:00,0,1035,1035,27,11.55
2017-08-01 03:00:00+00:00,0,1033,1033,29,11.342
2017-08-01 04:00:00+00:00,27,1048,1075,34,12.357
2017-08-01 05:00:00+00:00,125,915,1040,40,15.103
2017-08-01 06:00:00+00:00,270,761,1031,41,17.3
2017-08-01 07:00:00+00:00,426,1022,1448,40,19.702
2017-08-01 08:00:00+00:00,562,1318,1880,38,21.584
2017-08-01 09:00:00+00:00,658,1516,2174,38,22.871
2017-08-01 10:00:00+00:00,706,1619,2325,36,23.696
2017-08-01 11:00:00+00:00,713,1680,2393,35,24.095
2017-08-01 12:00:00+00:00,685,1690,2375,34,24.156
2017-08-01 13:00:00+00:00,620,1625,2245,34,23.932
2017-08-01 14:00:00+00:00,516,1682,2198,35,23.782
2017-08-01 15:00:00+00:00,379,1555,1934,38,23.477
2017-08-01 16:00:00+00:00,229,1405,1634,39,21.911
2017-08-01 17:00:00+00:00,87,1405,1492,40,19.152
2017-08-01 18:00:00+00:00,16,1535,1551,39,16.699
2017-08-01 19:00:00+00:00,0,1569,1569,38,15.918
2017-08-01 20:00:00+00:00,0,1749,1749,36,15.374
2017-08-01 21:00:00+00:00,0,1687,1687,31,15.091
2017-08-01 22:00:00+00:00,0,1561,1561,29,15.136
2017-08-01 23:00:00+00:00,0,1366,1366,27,15.272
2017-08-02 00:00:00+00:00,0,873,873,26,14.884
2017-08-02 01:00:00+00:00,0,443,443,26,14.535
2017-08-02 02:00:00+00:00,0,388,388,26,14.646
2017-08-02 03:00:00+00:00,0,525,525,27,14.607
2017-08-02 04:00:00+00:00,25,965,990,31,14.641
2017-08-02 05:00:00+00:00,101,874,975,36,16.298
2017-08-02 06:00:00+00:00,221,1314,1535,38,19.353
2017-08-02 07:00:00+00:00,351,1582,1933,38,21.958
2017-08-02 08:00:00+00:00,461,1401,1862,37,22.532
2017-08-02 09:00:00+00:00,525,783,1308,35,22.925
2017-08-02 10:00:00+00:00,563,302,865,33,23.433
2017-08-02 11:00:00+00:00,614,165,779,32,23.509
2017-08-02 12:00:00+00:00,621,148,769,32,23.061
2017-08-02 13:00:00+00:00,569,102,671,32,22.499
2017-08-02 14:00:00+00:00,482,66,548,35,23.088
2017-08-02 15:00:00+00:00,359,38,397,37,22.345
2017-08-02 16:00:00+00:00,212,57,269,40,21.102
2017-08-02 17:00:00+00:00,82,90,172,42,18.606
2017-08-02 18:00:00+00:00,17,185,202,41,17.01
2017-08-02 19:00:00+00:00,0,283,283,39,15.935
2017-08-02 20:00:00+00:00,0,174,174,37,14.99
2017-08-02 21:00:00+00:00,0,115,115,33,14.413
2017-08-02 22:00:00+00:00,0,106,106,29,13.936
2017-08-02 23:00:00+00:00,0,102,102,26,13.478
2017-08-03 00:00:00+00:00,0,106,106,25,13.152
2017-08-03 01:00:00+00:00,0,80,80,24,12.831
2017-08-03 02:00:00+00:00,0,61,61,24,12.567
2017-08-03 03:00:00+00:00,0,60,60,25,12.171
2017-08-03 04:00:00+00:00,23,38,61,30,12.615
2017-08-03 05:00:00+00:00,109,27,136,34,15.357
2017-08-03 06:00:00+00:00,237,15,252,34,16.993
2017-08-03 07:00:00+00:00,379,12,391,34,19.51
2017-08-03 08:00:00+00:00,509,31,540,33,21.555
2017-08-03 09:00:00+00:00,597,85,682,32,22.908
2017-08-03 10:00:00+00:00,661,192,853,28,23.834
2017-08-03 11:00:00+00:00,682,331,1013,26,24.315
2017-08-03 12:00:00+00:00,651,449,1100,22,24.277
2017-08-03 13:00:00+00:00,571,514,1085,21,23.555
2017-08-03 14:00:00+00:00,453,509,962,21,22.673
2017-08-03 15:00:00+00:00,325,433,758,23,22.314
2017-08-03 16:00:00+00:00,190,577,767,26,21.099
2017-08-03 17:00:00+00:00,67,621,688,29,19.207
2017-08-03 18:00:00+00:00,11,786,797,32,18.158
2017-08-03 19:00:00+00:00,0,722,722,31,17.496
2017-08-03 20:00:00+00:00,0,275,275,30,16.815
2017-08-03 21:00:00+00:00,0,154,154,26,16.294
2017-08-03 22:00:00+00:00,0,83,83,23,15.988
2017-08-03 23:00:00+00:00,0,43,43,21,15.799
2017-08-04 00:00:00+00:00,0,25,25,19,15.726
2017-08-04 01:00:00+00:00,0,20,20,18,15.852
2017-08-04 02:00:00+00:00,0,12,12,18,16.088
2017-08-04 03:00:00+00:00,0,16,16,23,16.08
2017-08-04 04:00:00+00:00,18,25,43,27,16.038
2017-08-04 05:00:00+00:00,96,43,139,31,17.483
2017-08-04 06:00:00+00:00,214,44,258,32,19.759
2017-08-04 07:00:00+00:00,348,47,395,30,22.709
2017-08-04 08:00:00+00:00,464,49,513,25,22.617
2017-08-04 09:00:00+00:00,553,118,671,22,23.665
2017-08-04 10:00:00+00:00,600,153,753,16,23.887
2017-08-04 11:00:00+00:00,617,187,804,11,24.015
2017-08-04 12:00:00+00:00,599,229,828,9,23.543
2017-08-04 13:00:00+00:00,533,293,826,10,23.051
2017-08-04 14:00:00+00:00,428,234,662,11,22.105
2017-08-04 15:00:00+00:00,307,112,419,19,21.781
2017-08-04 16:00:00+00:00,189,108,297,25,19.98
2017-08-04 17:00:00+00:00,74,160,234,29,18.739
2017-08-04 18:00:00+00:00,14,176,190,31,17.932
2017-08-04 19:00:00+00:00,0,227,227,31,17.339
2017-08-04 20:00:00+00:00,0,283,283,31,16.873
2017-08-04 21:00:00+00:00,0,478,478,27,16.277
2017-08-04 22:00:00+00:00,0,606,606,28,15.682
2017-08-04 23:00:00+00:00,0,612,612,27,15.177
2017-08-05 00:00:00+00:00,0,196,196,25,14.791
2017-08-05 01:00:00+00:00,0,231,231,23,14.511
2017-08-05 02:00:00+00:00,0,568,568,21,14.267
2017-08-05 03:00:00+00:00,0,884,884,23,14.005
2017-08-05 04:00:00+00:00,16,793,809,25,14.186
2017-08-05 05:00:00+00:00,92,497,589,27,15.607
2017-08-05 06:00:00+00:00,204,262,466,30,18.582
2017-08-05 07:00:00+00:00,332,128,460,32,20.646
2017-08-05 08:00:00+00:00,451,69,520,31,22.007
2017-08-05 09:00:00+00:00,540,39,579,30,22.278
2017-08-05 10:00:00+00:00,599,22,621,28,22.584
2017-08-05 11:00:00+00:00,620,13,633,26,22.466
2017-08-05 12:00:00+00:00,593,11,604,26,22.296
2017-08-05 13:00:00+00:00,516,20,536,27,21.683
2017-08-05 14:00:00+00:00,408,12,420,28,20.981
2017-08-05 15:00:00+00:00,284,14,298,30,20.016
2017-08-05 16:00:00+00:00,162,20,182,32,18.911
2017-08-05 17:00:00+00:00,59,36,95,35,17.879
2017-08-05 18:00:00+00:00,11,72,83,34,17.233
2017-08-05 19:00:00+00:00,0,118,118,35,16.711
2017-08-05 20:00:00+00:00,0,202,202,34,16.021
2017-08-05 21:00:00+00:00,0,226,226,31,15.584
2017-08-05 22:00:00+00:00,0,308,308,28,15.246
2017-08-05 23:00:00+00:00,0,873,873,24,15.149
2017-08-06 00:00:00+00:00,0,466,466,20,14.898
2017-08-06 01:00:00+00:00,0,478,478,17,14.154
2017-08-06 02:00:00+00:00,0,1193,1193,19,13.17
2017-08-06 03:00:00+00:00,0,1472,1472,19,12.253
2017-08-06 04:00:00+00:00,12,1060,1072,19,11.919
2017-08-06 05:00:00+00:00,69,634,703,20,11.92
2017-08-06 06:00:00+00:00,153,746,899,19,12.192
2017-08-06 07:00:00+00:00,248,1045,1293,20,12.576
2017-08-06 08:00:00+00:00,323,1136,1459,20,13.257
2017-08-06 09:00:00+00:00,334,993,1327,21,13.953
2017-08-06 10:00:00+00:00,350,725,1075,18,14.661
2017-08-06 11:00:00+00:00,383,540,923,15,15.088
2017-08-06 12:00:00+00:00,361,517,878,13,14.788
2017-08-06 13:00:00+00:00,295,788,1083,14,14.096
2017-08-06 14:00:00+00:00,254,1040,1294,17,13.555
2017-08-06 15:00:00+00:00,202,1248,1450,22,12.894
2017-08-06 16:00:00+00:00,123,1020,1143,28,11.869
2017-08-06 17:00:00+00:00,48,1058,1106,33,10.088
2017-08-06 18:00:00+00:00,10,1487,1497,35,7.836
2017-08-06 19:00:00+00:00,0,1326,1326,36,6.03
2017-08-06 20:00:00+00:00,0,1004,1004,37,5.854
2017-08-06 21:00:00+00:00,0,1218,1218,35,6.04
2017-08-06 22:00:00+00:00,0,1355,1355,26,6.319
2017-08-06 23:00:00+00:00,0,1361,1361,24,6.696
2017-08-07 00:00:00+00:00,0,1413,1413,23,6.991
2017-08-07 01:00:00+00:00,0,1425,1425,22,7.11
2017-08-07 02:00:00+00:00,0,1165,1165,23,7.005
2017-08-07 03:00:00+00:00,0,1296,1296,27,6.929
2017-08-07 04:00:00+00:00,21,1372,1393,34,7.355
2017-08-07 05:00:00+00:00,111,1138,1249,38,8.245
2017-08-07 06:00:00+00:00,251,851,1102,38,9.334
2017-08-07 07:00:00+00:00,405,637,1042,37,10.966
2017-08-07 08:00:00+00:00,537,379,916,35,13.396
2017-08-07 09:00:00+00:00,628,283,911,34,15.577
2017-08-07 10:00:00+00:00,692,221,913,31,17.075
2017-08-07 11:00:00+00:00,708,154,862,30,18.1
2017-08-07 12:00:00+00:00,692,117,809,29,18.694
2017-08-07 13:00:00+00:00,633,91,724,30,18.85
2017-08-07 14:00:00+00:00,525,54,579,31,18.492
2017-08-07 15:00:00+00:00,383,43,426,36,17.691
2017-08-07 16:00:00+00:00,230,69,299,39,17.31
2017-08-07 17:00:00+00:00,91,136,227,40,15.205
2017-08-07 18:00:00+00:00,18,308,326,40,12.436
2017-08-07 19:00:00+00:00,0,501,501,38,10.78
2017-08-07 20:00:00+00:00,0,494,494,36,9.867
2017-08-07 21:00:00+00:00,0,547,547,31,9.311
2017-08-07 22:00:00+00:00,0,576,576,28,8.814
2017-08-07 23:00:00+00:00,0,559,559,26,8.441
2017-08-08 00:00:00+00:00,0,635,635,25,8.199
2017-08-08 01:00:00+00:00,0,689,689,25,7.947
2017-08-08 02:00:00+00:00,0,668,668,24,7.732
2017-08-08 03:00:00+00:00,0,740,740,27,7.568
2017-08-08 04:00:00+00:00,22,810,832,33,8.413
2017-08-08 05:00:00+00:00,114,701,815,36,10.583
2017-08-08 06:00:00+00:00,253,816,1069,38,12.818
2017-08-08 07:00:00+00:00,401,907,1308,38,15.163
2017-08-08 08:00:00+00:00,532,1041,1573,36,17.195
2017-08-08 09:00:00+00:00,626,1175,1801,35,18.71
2017-08-08 10:00:00+00:00,678,1274,1952,31,19.761
2017-08-08 11:00:00+00:00,693,1283,1976,29,20.379
2017-08-08 12:00:00+00:00,669,1403,2072,28,20.579
2017-08-08 13:00:00+00:00,600,1543,2143,29,20.475
2017-08-08 14:00:00+00:00,488,1434,1922,31,20.101
2017-08-08 15:00:00+00:00,358,1298,1656,34,19.611
2017-08-08 16:00:00+00:00,216,1080,1296,37,18.596
2017-08-08 17:00:00+00:00,83,919,1002,39,16.393
2017-08-08 18:00:00+00:00,16,1060,1076,36,14.225
2017-08-08 19:00:00+00:00,0,1368,1368,35,13.405
2017-08-08 20:00:00+00:00,0,1488,1488,32,12.842
2017-08-08 21:00:00+00:00,0,1361,1361,27,12.218
2017-08-08 22:00:00+00:00,0,1212,1212,26,11.654
2017-08-08 23:00:00+00:00,0,756,756,23,11.21
2017-08-09 00:00:00+00:00,0,389,389,22,10.869
2017-08-09 01:00:00+00:00,0,269,269,20,10.571
2017-08-09 02:00:00+00:00,0,170,170,21,10.546
2017-08-09 03:00:00+00:00,0,74,74,24,10.673
2017-08-09 04:00:00+00:00,18,159,177,30,10.778
2017-08-09 05:00:00+00:00,99,133,232,34,12.001
2017-08-09 06:00:00+00:00,217,175,392,35,13.165
2017-08-09 07:00:00+00:00,352,162,514,34,15.095
2017-08-09 08:00:00+00:00,489,109,598,32,17.428
2017-08-09 09:00:00+00:00,602,111,713,30,19.1
2017-08-09 10:00:00+00:00,671,74,745,28,19.857
2017-08-09 11:00:00+00:00,685,127,812,27,20.044
2017-08-09 12:00:00+00:00,651,218,869,27,19.994
2017-08-09 13:00:00+00:00,573,313,886,28,19.722
2017-08-09 14:00:00+00:00,462,367,829,30,19.277
2017-08-09 15:00:00+00:00,332,384,716,34,18.63
2017-08-09 16:00:00+00:00,195,349,544,37,17.665
2017-08-09 17:00:00+00:00,70,289,359,39,15.986
2017-08-09 18:00:00+00:00,12,342,354,39,13.882
2017-08-09 19:00:00+00:00,0,394,394,38,13.35
2017-08-09 20:00:00+00:00,0,452,452,36,13.069
2017-08-09 21:00:00+00:00,0,496,496,32,12.721
2017-08-09 22:00:00+00:00,0,665,665,30,12.353
2017-08-09 23:00:00+00:00,0,757,757,28,12.021
2017-08-10 00:00:00+00:00,0,527,527,27,11.921
2017-08-10 01:00:00+00:00,0,486,486,26,12.064
2017-08-10 02:00:00+00:00,0,301,301,26,12.143
2017-08-10 03:00:00+00:00,0,896,896,28,12.34
2017-08-10 04:00:00+00:00,15,846,861,34,12.718
2017-08-10 05:00:00+00:00,87,434,521,39,14.386
2017-08-10 06:00:00+00:00,186,173,359,41,16.459
2017-08-10 07:00:00+00:00,291,75,366,41,18.373
2017-08-10 08:00:00+00:00,379,102,481,41,19.554
2017-08-10 09:00:00+00:00,432,105,537,42,19.469
2017-08-10 10:00:00+00:00,459,84,543,41,18.717
2017-08-10 11:00:00+00:00,448,116,564,40,18.516
2017-08-10 12:00:00+00:00,435,286,721,38,18.586
2017-08-10 13:00:00+00:00,402,470,872,38,18.171
2017-08-10 14:00:00+00:00,340,851,1191,36,17.479
2017-08-10 15:00:00+00:00,249,256,505,37,16.847
2017-08-10 16:00:00+00:00,152,171,323,38,15.539
2017-08-10 17:00:00+00:00,57,259,316,39,14.227
2017-08-10 18:00:00+00:00,10,338,348,38,13.047
2017-08-10 19:00:00+00:00,0,465,465,36,12.495
2017-08-10 20:00:00+00:00,0,1729,1729,35,11.988
2017-08-10 21:00:00+00:00,0,1887,1887,31,11.545
2017-08-10 22:00:00+00:00,0,1156,1156,29,11.151
2017-08-10 23:00:00+00:00,0,767,767,27,10.854
2017-08-11 00:00:00+00:00,0,698,698,27,10.627
2017-08-11 01:00:00+00:00,0,464,464,26,10.419
2017-08-11 02:00:00+00:00,0,402,402,26,10.233
2017-08-11 03:00:00+00:00,0,730,730,27,9.996
2017-08-11 04:00:00+00:00,9,678,687,32,10.031
2017-08-11 05:00:00+00:00,60,663,723,37,10.497
2017-08-11 06:00:00+00:00,138,661,799,41,10.931
2017-08-11 07:00:00+00:00,224,435,659,42,11.271
2017-08-11 08:00:00+00:00,274,489,763,45,11.819
2017-08-11 09:00:00+00:00,297,503,800,44,12.517
2017-08-11 10:00:00+00:00,342,418,760,42,13.311
2017-08-11 11:00:00+00:00,366,357,723,41,14.238
2017-08-11 12:00:00+00:00,392,581,973,39,14.27
2017-08-11 13:00:00+00:00,373,1170,1543,38,13.745
2017-08-11 14:00:00+00:00,321,1178,1499,36,13.17
2017-08-11 15:00:00+00:00,256,1253,1509,37,12.621
2017-08-11 16:00:00+00:00,161,1646,1807,38,11.863
2017-08-11 17:00:00+00:00,64,1556,1620,38,10.484
2017-08-11 18:00:00+00:00,13,1578,1591,36,9.076
2017-08-11 19:00:00+00:00,0,1535,1535,35,8.452
2017-08-11 20:00:00+00:00,0,1668,1668,34,7.672
2017-08-11 21:00:00+00:00,0,1683,1683,30,7.042
2017-08-11 22:00:00+00:00,0,1792,1792,28,6.733
2017-08-11 23:00:00+00:00,0,1868,1868,25,6.446
2017-08-12 00:00:00+00:00,0,2024,2024,22,6.265
2017-08-12 01:00:00+00:00,0,2002,2002,20,6.268
2017-08-12 02:00:00+00:00,0,1692,1692,19,6.314
2017-08-12 03:00:00+00:00,0,1571,1571,20,6.239
2017-08-12 04:00:00+00:00,13,1513,1526,21,6.296
2017-08-12 05:00:00+00:00,77,1471,1548,24,6.642
2017-08-12 06:00:00+00:00,166,1631,1797,27,7.186
2017-08-12 07:00:00+00:00,261,1871,2132,29,8.211
2017-08-12 08:00:00+00:00,350,1729,2079,30,9.732
2017-08-12 09:00:00+00:00,425,1811,2236,28,11.254
2017-08-12 10:00:00+00:00,473,2043,2516,26,12.359
2017-08-12 11:00:00+00:00,492,2063,2555,22,12.894
2017-08-12 12:00:00+00:00,484,2107,2591,20,12.99
2017-08-12 13:00:00+00:00,449,2009,2458,20,12.778
2017-08-12 14:00:00+00:00,380,1947,2327,21,12.311
2017-08-12 15:00:00+00:00,280,2076,2356,25,11.589
2017-08-12 16:00:00+00:00,168,2131,2299,27,10.587
2017-08-12 17:00:00+00:00,67,1955,2022,29,9.098
2017-08-12 18:00:00+00:00,15,1634,1649,28,7.214
2017-08-12 19:00:00+00:00,0,1569,1569,27,6.683
2017-08-12 20:00:00+00:00,0,1604,1604,26,6.29
2017-08-12 21:00:00+00:00,0,1589,1589,23,5.962
2017-08-12 22:00:00+00:00,0,1709,1709,18,6.055
2017-08-12 23:00:00+00:00,0,1582,1582,14,6.268
2017-08-13 00:00:00+00:00,0,1517,1517,12,6.365
2017-08-13 01:00:00+00:00,0,1448,1448,12,6.474
2017-08-13 02:00:00+00:00,0,1533,1533,12,6.487
2017-08-13 03:00:00+00:00,0,1432,1432,12,6.318
2017-08-13 04:00:00+00:00,15,1436,1451,13,6.564
2017-08-13 05:00:00+00:00,90,1334,1424,17,7.546
2017-08-13 06:00:00+00:00,213,1370,1583,19,8.648
2017-08-13 07:00:00+00:00,355,1484,1839,19,10.423
2017-08-13 08:00:00+00:00,486,1324,1810,17,12.561
2017-08-13 09:00:00+00:00,582,1165,1747,18,14.284
2017-08-13 10:00:00+00:00,631,1069,1700,19,15.559
2017-08-13 11:00:00+00:00,631,880,1511,15,16.396
2017-08-13 12:00:00+00:00,590,793,1383,13,16.696
2017-08-13 13:00:00+00:00,522,800,1322,14,16.546
2017-08-13 14:00:00+00:00,432,792,1224,17,15.898
2017-08-13 15:00:00+00:00,327,710,1037,24,15.075
2017-08-13 16:00:00+00:00,203,610,813,30,14.185
2017-08-13 17:00:00+00:00,75,481,556,33,12.643
2017-08-13 18:00:00+00:00,13,509,522,35,11.239
2017-08-13 19:00:00+00:00,0,656,656,34,10.836
2017-08-13 20:00:00+00:00,0,647,647,35,10.43
2017-08-13 21:00:00+00:00,0,455,455,33,10.025
2017-08-13 22:00:00+00:00,0,329,329,30,9.735
2017-08-13 23:00:00+00:00,0,267,267,28,9.464
2017-08-14 00:00:00+00:00,0,194,194,25,9.174
2017-08-14 01:00:00+00:00,0,175,175,24,8.824
2017-08-14 02:00:00+00:00,0,152,152,24,8.482
2017-08-14 03:00:00+00:00,0,107,107,26,7.993
2017-08-14 04:00:00+00:00,17,114,131,34,7.99
2017-08-14 05:00:00+00:00,100,126,226,39,10.314
2017-08-14 06:00:00+00:00,231,102,333,40,12.157
2017-08-14 07:00:00+00:00,380,78,458,39,14.3
2017-08-14 08:00:00+00:00,511,58,569,36,16.04
2017-08-14 09:00:00+00:00,611,53,664,36,17.231
2017-08-14 10:00:00+00:00,665,34,699,34,17.836
2017-08-14 11:00:00+00:00,681,28,709,33,18.182
2017-08-14 12:00:00+00:00,653,31,684,31,18.029
2017-08-14 13:00:00+00:00,579,32,611,32,17.642
2017-08-14 14:00:00+00:00,465,34,499,32,17.054
2017-08-14 15:00:00+00:00,330,40,370,36,16.947
2017-08-14 16:00:00+00:00,196,45,241,40,15.762
2017-08-14 17:00:00+00:00,71,89,160,41,14.301
2017-08-14 18:00:00+00:00,12,200,212,39,13.142
2017-08-14 19:00:00+00:00,0,355,355,37,12.323
2017-08-14 20:00:00+00:00,0,395,395,34,11.65
2017-08-14 21:00:00+00:00,0,318,318,28,11.211
2017-08-14 22:00:00+00:00,0,226,226,24,10.82
2017-08-14 23:00:00+00:00,0,188,188,22,10.489
2017-08-15 00:00:00+00:00,0,205,205,20,10.25
2017-08-15 01:00:00+00:00,0,135,135,20,10.059
2017-08-15 02:00:00+00:00,0,130,130,20,9.915
2017-08-15 03:00:00+00:00,0,185,185,22,9.609
2017-08-15 04:00:00+00:00,14,209,223,27,9.538
2017-08-15 05:00:00+00:00,92,148,240,30,11.814
2017-08-15 06:00:00+00:00,216,91,307,31,14.092
2017-08-15 07:00:00+00:00,359,166,525,30,17.041
2017-08-15 08:00:00+00:00,492,287,779,29,18.61
2017-08-15 09:00:00+00:00,598,404,1002,29,19.682
2017-08-15 10:00:00+00:00,660,459,1119,26,20.386
2017-08-15 11:00:00+00:00,680,384,1064,25,20.629
2017-08-15 12:00:00+00:00,659,293,952,23,20.468
2017-08-15 13:00:00+00:00,593,192,785,26,19.985
2017-08-15 14:00:00+00:00,489,126,615,27,19.168
2017-08-15 15:00:00+00:00,350,92,442,32,18.705
2017-08-15 16:00:00+00:00,198,96,294,34,18.553
2017-08-15 17:00:00+00:00,66,119,185,36,16.487
2017-08-15 18:00:00+00:00,10,175,185,36,15.154
2017-08-15 19:00:00+00:00,0,325,325,35,14.3
2017-08-15 20:00:00+00:00,0,600,600,34,13.618
2017-08-15 21:00:00+00:00,0,613,613,29,13.162
2017-08-15 22:00:00+00:00,0,508,508,27,12.892
2017-08-15 23:00:00+00:00,0,429,429,25,12.604
2017-08-16 00:00:00+00:00,0,449,449,24,12.34
2017-08-16 01:00:00+00:00,0,507,507,23,12.1
2017-08-16 02:00:00+00:00,0,412,412,24,11.963
2017-08-16 03:00:00+00:00,0,289,289,27,11.78
2017-08-16 04:00:00+00:00,13,271,284,33,11.744
2017-08-16 05:00:00+00:00,82,243,325,38,12.677
2017-08-16 06:00:00+00:00,190,167,357,41,14.594
2017-08-16 07:00:00+00:00,303,179,482,41,15.112
2017-08-16 08:00:00+00:00,386,275,661,39,14.279
2017-08-16 09:00:00+00:00,450,387,837,38,14.378
2017-08-16 10:00:00+00:00,485,410,895,35,15.064
2017-08-16 11:00:00+00:00,446,387,833,33,16.091
2017-08-16 12:00:00+00:00,435,749,1184,33,16.583
2017-08-16 13:00:00+00:00,417,1027,1444,34,16.498
2017-08-16 14:00:00+00:00,363,940,1303,35,16.131
2017-08-16 15:00:00+00:00,285,694,979,39,15.582
2017-08-16 16:00:00+00:00,176,589,765,43,14.976
2017-08-16 17:00:00+00:00,62,482,544,45,13.616
2017-08-16 18:00:00+00:00,10,389,399,43,12.436
2017-08-16 19:00:00+00:00,0,487,487,41,12.196
2017-08-16 20:00:00+00:00,0,619,619,37,12.003
2017-08-16 21:00:00+00:00,0,618,618,33,11.749
2017-08-16 22:00:00+00:00,0,575,575,32,11.454
2017-08-16 23:00:00+00:00,0,410,410,30,11.214
2017-08-17 00:00:00+00:00,0,338,338,29,11.045
2017-08-17 01:00:00+00:00,0,369,369,28,10.864
2017-08-17 02:00:00+00:00,0,354,354,28,10.658
2017-08-17 03:00:00+00:00,0,362,362,29,10.278
2017-08-17 04:00:00+00:00,16,343,359,33,10.091
2017-08-17 05:00:00+00:00,111,233,344,38,12.036
2017-08-17 06:00:00+00:00,265,121,386,40,14.688
2017-08-17 07:00:00+00:00,434,81,515,39,18.38
2017-08-17 08:00:00+00:00,583,73,656,37,19.841
2017-08-17 09:00:00+00:00,693,46,739,36,20.451
2017-08-17 10:00:00+00:00,746,21,767,33,19.734
2017-08-17 11:00:00+00:00,756,25,781,32,19.58
2017-08-17 12:00:00+00:00,722,13,735,31,19.458
2017-08-17 13:00:00+00:00,647,12,659,31,19.18
2017-08-17 14:00:00+00:00,532,21,553,33,18.645
2017-08-17 15:00:00+00:00,389,8,397,36,18.154
2017-08-17 16:00:00+00:00,230,4,234,38,17.603
2017-08-17 17:00:00+00:00,77,10,87,40,16.259
2017-08-17 18:00:00+00:00,10,13,23,38,15.424
2017-08-17 19:00:00+00:00,0,28,28,38,14.824
2017-08-17 20:00:00+00:00,0,56,56,34,14.013
2017-08-17 21:00:00+00:00,0,91,91,30,13.265
2017-08-17 22:00:00+00:00,0,103,103,30,12.827
2017-08-17 23:00:00+00:00,0,98,98,29,12.48
2017-08-18 00:00:00+00:00,0,101,101,27,12.124
2017-08-18 01:00:00+00:00,0,89,89,27,11.799
2017-08-18 02:00:00+00:00,0,73,73,27,11.707
2017-08-18 03:00:00+00:00,0,54,54,28,11.407
2017-08-18 04:00:00+00:00,11,32,43,32,11.193
2017-08-18 05:00:00+00:00,86,23,109,37,12.866
2017-08-18 06:00:00+00:00,210,18,228,40,14.93
2017-08-18 07:00:00+00:00,351,7,358,39,17.031
2017-08-18 08:00:00+00:00,474,6,480,38,18.482
2017-08-18 09:00:00+00:00,562,36,598,38,18.986
2017-08-18 10:00:00+00:00,603,77,680,34,19.433
2017-08-18 11:00:00+00:00,606,175,781,32,19.971
2017-08-18 12:00:00+00:00,569,331,900,32,20.576
2017-08-18 13:00:00+00:00,494,567,1061,31,20.667
2017-08-18 14:00:00+00:00,397,738,1135,32,20.314
2017-08-18 15:00:00+00:00,279,863,1142,35,19.57
2017-08-18 16:00:00+00:00,159,885,1044,37,18.343
2017-08-18 17:00:00+00:00,49,999,1048,38,15.948
2017-08-18 18:00:00+00:00,6,1217,1223,38,13.682
2017-08-18 19:00:00+00:00,0,1427,1427,36,12.889
2017-08-18 20:00:00+00:00,0,1537,1537,35,12.244
2017-08-18 21:00:00+00:00,0,1536,1536,31,11.721
2017-08-18 22:00:00+00:00,0,1447,1447,23,11.698
2017-08-18 23:00:00+00:00,0,1534,1534,18,12.151
2017-08-19 00:00:00+00:00,0,2080,2080,15,11.851
2017-08-19 01:00:00+00:00,0,1436,1436,13,10.955
2017-08-19 02:00:00+00:00,0,1063,1063,11,10.276
2017-08-19 03:00:00+00:00,0,1205,1205,12,10.018
2017-08-19 04:00:00+00:00,8,1241,1249,12,10.029
2017-08-19 05:00:00+00:00,64,1049,1113,14,10.304
2017-08-19 06:00:00+00:00,152,1164,1316,16,10.727
2017-08-19 07:00:00+00:00,243,1288,1531,10,11.257
2017-08-19 08:00:00+00:00,300,942,1242,10,11.79
2017-08-19 09:00:00+00:00,329,1031,1360,3,12
2017-08-19 10:00:00+00:00,345,814,1159,-2,12.334
2017-08-19 11:00:00+00:00,342,361,703,-9,12.44
2017-08-19 12:00:00+00:00,324,399,723,-13,12.424
2017-08-19 13:00:00+00:00,297,569,866,-9,12.394
2017-08-19 14:00:00+00:00,252,347,599,-1,12.155
2017-08-19 15:00:00+00:00,192,222,414,11,11.805
2017-08-19 16:00:00+00:00,128,224,352,19,11.123
2017-08-19 17:00:00+00:00,45,426,471,24,10.328
2017-08-19 18:00:00+00:00,6,654,660,27,9.772
2017-08-19 19:00:00+00:00,0,1063,1063,27,8.716
2017-08-19 20:00:00+00:00,0,1419,1419,27,7.355
2017-08-19 21:00:00+00:00,0,1050,1050,21,6.249
2017-08-19 22:00:00+00:00,0,871,871,16,5.118
2017-08-19 23:00:00+00:00,0,815,815,12,4.65
2017-08-20 00:00:00+00:00,0,1094,1094,8,4.59
2017-08-20 01:00:00+00:00,0,1220,1220,8,4.739
2017-08-20 02:00:00+00:00,0,1004,1004,8,5.058
2017-08-20 03:00:00+00:00,0,967,967,7,5.409
2017-08-20 04:00:00+00:00,7,1184,1191,8,5.609
2017-08-20 05:00:00+00:00,58,1593,1651,9,6.405
2017-08-20 06:00:00+00:00,130,1556,1686,5,7.154
2017-08-20 07:00:00+00:00,224,1244,1468,5,7.909
2017-08-20 08:00:00+00:00,309,1017,1326,2,8.976
2017-08-20 09:00:00+00:00,380,1008,1388,2,10.03
2017-08-20 10:00:00+00:00,439,986,1425,-10,10.958
2017-08-20 11:00:00+00:00,470,910,1380,-18,11.817
2017-08-20 12:00:00+00:00,486,855,1341,-22,12.188
2017-08-20 13:00:00+00:00,458,669,1127,-11,12.1
2017-08-20 14:00:00+00:00,373,539,912,-5,11.739
2017-08-20 15:00:00+00:00,271,535,806,9,11.052
2017-08-20 16:00:00+00:00,157,795,952,21,9.959
2017-08-20 17:00:00+00:00,53,774,827,26,8.301
2017-08-20 18:00:00+00:00,9,537,546,30,6.71
2017-08-20 19:00:00+00:00,0,584,584,30,6.289
2017-08-20 20:00:00+00:00,0,664,664,30,6.034
2017-08-20 21:00:00+00:00,0,773,773,26,5.754
2017-08-20 22:00:00+00:00,0,752,752,24,5.547
2017-08-20 23:00:00+00:00,0,908,908,22,5.415
2017-08-21 00:00:00+00:00,0,923,923,21,5.272
2017-08-21 01:00:00+00:00,0,897,897,21,5.082
2017-08-21 02:00:00+00:00,0,810,810,21,5.001
2017-08-21 03:00:00+00:00,0,766,766,24,4.862
2017-08-21 04:00:00+00:00,12,687,699,33,5.104
2017-08-21 05:00:00+00:00,90,649,739,38,6.651
2017-08-21 06:00:00+00:00,224,526,750,40,7.831
2017-08-21 07:00:00+00:00,382,469,851,39,8.814
2017-08-21 08:00:00+00:00,519,388,907,37,10.181
2017-08-21 09:00:00+00:00,608,534,1142,37,11.665
2017-08-21 10:00:00+00:00,649,557,1206,34,12.621
2017-08-21 11:00:00+00:00,652,574,1226,33,13.173
2017-08-21 12:00:00+00:00,620,663,1283,31,13.366
2017-08-21 13:00:00+00:00,558,766,1324,31,13.198
2017-08-21 14:00:00+00:00,452,812,1264,34,12.695
2017-08-21 15:00:00+00:00,316,807,1123,39,11.872
2017-08-21 16:00:00+00:00,177,669,846,42,10.693
2017-08-21 17:00:00+00:00,58,647,705,43,8.334
2017-08-21 18:00:00+00:00,8,783,791,42,6.799
2017-08-21 19:00:00+00:00,0,770,770,40,6.482
2017-08-21 20:00:00+00:00,0,681,681,38,6.107
2017-08-21 21:00:00+00:00,0,525,525,32,5.791
2017-08-21 22:00:00+00:00,0,436,436,30,5.565
2017-08-21 23:00:00+00:00,0,421,421,28,5.393
2017-08-22 00:00:00+00:00,0,371,371,27,5.211
2017-08-22 01:00:00+00:00,0,320,320,27,4.988
2017-08-22 02:00:00+00:00,0,290,290,27,4.814
2017-08-22 03:00:00+00:00,0,308,308,29,4.579
2017-08-22 04:00:00+00:00,11,311,322,36,4.436
2017-08-22 05:00:00+00:00,90,288,378,42,6.18
2017-08-22 06:00:00+00:00,226,154,380,44,8.912
2017-08-22 07:00:00+00:00,380,77,457,41,11.044
2017-08-22 08:00:00+00:00,515,70,585,38,12.533
2017-08-22 09:00:00+00:00,613,83,696,37,13.804
2017-08-22 10:00:00+00:00,668,132,800,35,14.805
2017-08-22 11:00:00+00:00,679,142,821,34,15.484
2017-08-22 12:00:00+00:00,649,132,781,32,15.738
2017-08-22 13:00:00+00:00,573,143,716,33,15.591
2017-08-22 14:00:00+00:00,449,159,608,35,15.015
2017-08-22 15:00:00+00:00,304,179,483,39,14.063
2017-08-22 16:00:00+00:00,167,143,310,42,12.776
2017-08-22 17:00:00+00:00,51,121,172,45,10.475
2017-08-22 18:00:00+00:00,7,192,199,44,9.168
2017-08-22 19:00:00+00:00,0,307,307,42,8.838
2017-08-22 20:00:00+00:00,0,394,394,39,8.39
2017-08-22 21:00:00+00:00,0,404,404,34,7.958
2017-08-22 22:00:00+00:00,0,409,409,32,7.666
2017-08-22 23:00:00+00:00,0,275,275,30,7.418
2017-08-23 00:00:00+00:00,0,190,190,30,7.128
2017-08-23 01:00:00+00:00,0,178,178,28,6.851
2017-08-23 02:00:00+00:00,0,236,236,28,6.618
2017-08-23 03:00:00+00:00,0,256,256,31,6.238
2017-08-23 04:00:00+00:00,10,314,324,38,5.954
2017-08-23 05:00:00+00:00,82,260,342,43,7.451
2017-08-23 06:00:00+00:00,209,86,295,43,9.87
2017-08-23 07:00:00+00:00,357,52,409,41,12.387
2017-08-23 08:00:00+00:00,496,97,593,38,14.296
2017-08-23 09:00:00+00:00,601,105,706,37,15.709
2017-08-23 10:00:00+00:00,660,115,775,36,16.704
2017-08-23 11:00:00+00:00,668,119,787,35,17.209
2017-08-23 12:00:00+00:00,630,133,763,34,17.277
2017-08-23 13:00:00+00:00,555,93,648,35,17.085
2017-08-23 14:00:00+00:00,445,46,491,36,16.631
2017-08-23 15:00:00+00:00,311,26,337,41,16.004
2017-08-23 16:00:00+00:00,170,10,180,43,15.148
2017-08-23 17:00:00+00:00,50,11,61,47,13.363
2017-08-23 18:00:00+00:00,6,19,25,43,12.48
2017-08-23 19:00:00+00:00,0,32,32,41,11.866
2017-08-23 20:00:00+00:00,0,42,42,37,11.136
2017-08-23 21:00:00+00:00,0,48,48,31,10.606
2017-08-23 22:00:00+00:00,0,67,67,30,10.131
2017-08-23 23:00:00+00:00,0,84,84,29,9.741
2017-08-24 00:00:00+00:00,0,91,91,27,9.395
2017-08-24 01:00:00+00:00,0,73,73,27,9.092
2017-08-24 02:00:00+00:00,0,71,71,28,8.912
2017-08-24 03:00:00+00:00,0,78,78,30,8.678
2017-08-24 04:00:00+00:00,9,90,99,36,8.68
2017-08-24 05:00:00+00:00,81,87,168,41,10.559
2017-08-24 06:00:00+00:00,205,70,275,42,13.524
2017-08-24 07:00:00+00:00,343,45,388,41,16.156
2017-08-24 08:00:00+00:00,465,32,497,38,18.105
2017-08-24 09:00:00+00:00,566,28,594,37,19.182
2017-08-24 10:00:00+00:00,621,40,661,34,19.649
2017-08-24 11:00:00+00:00,624,56,680,32,19.938
2017-08-24 12:00:00+00:00,585,40,625,31,20.028
2017-08-24 13:00:00+00:00,513,32,545,32,19.907
2017-08-24 14:00:00+00:00,414,39,453,34,19.348
2017-08-24 15:00:00+00:00,292,67,359,38,19.254
2017-08-24 16:00:00+00:00,157,145,302,43,17.624
2017-08-24 17:00:00+00:00,42,278,320,45,16.077
2017-08-24 18:00:00+00:00,3,424,427,44,15.265
2017-08-24 19:00:00+00:00,0,467,467,42,14.675
2017-08-24 20:00:00+00:00,0,458,458,38,14.239
2017-08-24 21:00:00+00:00,0,355,355,34,13.842
2017-08-24 22:00:00+00:00,0,251,251,33,13.326
2017-08-24 23:00:00+00:00,0,390,390,32,12.792
2017-08-25 00:00:00+00:00,0,878,878,30,12.213
2017-08-25 01:00:00+00:00,0,1108,1108,29,11.655
2017-08-25 02:00:00+00:00,0,517,517,30,11.179
2017-08-25 03:00:00+00:00,0,100,100,32,10.833
2017-08-25 04:00:00+00:00,5,112,117,38,10.666
2017-08-25 05:00:00+00:00,66,76,142,43,11.784
2017-08-25 06:00:00+00:00,177,51,228,45,13.986
2017-08-25 07:00:00+00:00,307,31,338,43,16.19
2017-08-25 08:00:00+00:00,440,20,460,40,18.29
2017-08-25 09:00:00+00:00,541,19,560,39,19.397
2017-08-25 10:00:00+00:00,611,41,652,36,19.889
2017-08-25 11:00:00+00:00,644,65,709,34,19.958
2017-08-25 12:00:00+00:00,619,93,712,33,19.882
2017-08-25 13:00:00+00:00,551,107,658,34,19.454
2017-08-25 14:00:00+00:00,443,82,525,36,18.858
2017-08-25 15:00:00+00:00,307,62,369,41,19.016
2017-08-25 16:00:00+00:00,163,76,239,45,18.147
2017-08-25 17:00:00+00:00,42,146,188,47,15.774
2017-08-25 18:00:00+00:00,3,206,209,47,14.27
2017-08-25 19:00:00+00:00,0,206,206,44,13.171
2017-08-25 20:00:00+00:00,0,203,203,40,12.29
2017-08-25 21:00:00+00:00,0,210,210,36,11.714
2017-08-25 22:00:00+00:00,0,246,246,34,11.248
2017-08-25 23:00:00+00:00,0,269,269,32,10.886
2017-08-26 00:00:00+00:00,0,194,194,31,10.716
2017-08-26 01:00:00+00:00,0,123,123,30,10.742
2017-08-26 02:00:00+00:00,0,113,113,29,10.97
2017-08-26 03:00:00+00:00,0,113,113,30,10.982
2017-08-26 04:00:00+00:00,6,126,132,30,11.052
2017-08-26 05:00:00+00:00,73,88,161,32,12.566
2017-08-26 06:00:00+00:00,199,34,233,35,15.243
2017-08-26 07:00:00+00:00,349,22,371,36,17.244
2017-08-26 08:00:00+00:00,493,21,514,34,19.884
2017-08-26 09:00:00+00:00,598,8,606,33,21.34
2017-08-26 10:00:00+00:00,652,5,657,31,21.653
2017-08-26 11:00:00+00:00,658,12,670,28,21.465
2017-08-26 12:00:00+00:00,618,23,641,27,21.297
2017-08-26 13:00:00+00:00,531,38,569,28,20.776
2017-08-26 14:00:00+00:00,413,40,453,30,20.339
2017-08-26 15:00:00+00:00,277,34,311,34,20.311
2017-08-26 16:00:00+00:00,144,30,174,39,17.841
2017-08-26 17:00:00+00:00,36,58,94,42,16.217
2017-08-26 18:00:00+00:00,2,74,76,42,15.202
2017-08-26 19:00:00+00:00,0,118,118,41,14.482
2017-08-26 20:00:00+00:00,0,144,144,39,13.909
2017-08-26 21:00:00+00:00,0,178,178,36,13.306
2017-08-26 22:00:00+00:00,0,212,212,31,12.804
2017-08-26 23:00:00+00:00,0,233,233,28,12.524
2017-08-27 00:00:00+00:00,0,259,259,25,12.321
2017-08-27 01:00:00+00:00,0,188,188,24,12.189
2017-08-27 02:00:00+00:00,0,168,168,22,12.135
2017-08-27 03:00:00+00:00,0,188,188,23,11.968
2017-08-27 04:00:00+00:00,5,194,199,24,11.627
2017-08-27 05:00:00+00:00,63,267,330,24,12.781
2017-08-27 06:00:00+00:00,177,224,401,26,15.619
2017-08-27 07:00:00+00:00,320,135,455,26,17.489
2017-08-27 08:00:00+00:00,453,148,601,26,20.701
2017-08-27 09:00:00+00:00,549,202,751,26,20.639
2017-08-27 10:00:00+00:00,589,161,750,25,20.906
2017-08-27 11:00:00+00:00,578,177,755,20,20.625
2017-08-27 12:00:00+00:00,534,198,732,18,19.991
2017-08-27 13:00:00+00:00,448,378,826,18,19.981
2017-08-27 14:00:00+00:00,328,613,941,22,19.214
2017-08-27 15:00:00+00:00,216,1212,1428,28,17.345
2017-08-27 16:00:00+00:00,113,1197,1310,33,16.387
2017-08-27 17:00:00+00:00,26,736,762,38,15.193
2017-08-27 18:00:00+00:00,1,439,440,39,14.106
2017-08-27 19:00:00+00:00,0,617,617,39,13.409
2017-08-27 20:00:00+00:00,0,648,648,40,12.995
2017-08-27 21:00:00+00:00,0,447,447,36,12.677
2017-08-27 22:00:00+00:00,0,378,378,31,12.384
2017-08-27 23:00:00+00:00,0,383,383,30,12.162
2017-08-28 00:00:00+00:00,0,454,454,30,12.069
2017-08-28 01:00:00+00:00,0,498,498,29,11.816
2017-08-28 02:00:00+00:00,0,463,463,29,11.437
2017-08-28 03:00:00+00:00,0,403,403,32,11.409
2017-08-28 04:00:00+00:00,4,370,374,41,11.546
2017-08-28 05:00:00+00:00,57,249,306,46,12.037
2017-08-28 06:00:00+00:00,150,143,293,48,12.854
2017-08-28 07:00:00+00:00,254,94,348,45,13.791
2017-08-28 08:00:00+00:00,360,110,470,43,14.626
2017-08-28 09:00:00+00:00,451,165,616,43,15.151
2017-08-28 10:00:00+00:00,509,161,670,40,15.803
2017-08-28 11:00:00+00:00,531,180,711,40,16.49
2017-08-28 12:00:00+00:00,502,180,682,38,16.373
2017-08-28 13:00:00+00:00,439,189,628,39,16.11
2017-08-28 14:00:00+00:00,355,202,557,41,15.752
2017-08-28 15:00:00+00:00,252,131,383,45,15.035
2017-08-28 16:00:00+00:00,134,91,225,48,14.132
2017-08-28 17:00:00+00:00,33,116,149,52,12.664
2017-08-28 18:00:00+00:00,2,326,328,51,11.79
2017-08-28 19:00:00+00:00,0,598,598,46,11.265
2017-08-28 20:00:00+00:00,0,590,590,41,10.623
2017-08-28 21:00:00+00:00,0,498,498,34,10.163
2017-08-28 22:00:00+00:00,0,378,378,32,9.781
2017-08-28 23:00:00+00:00,0,379,379,30,9.32
2017-08-29 00:00:00+00:00,0,268,268,30,8.806
2017-08-29 01:00:00+00:00,0,154,154,29,8.309
2017-08-29 02:00:00+00:00,0,98,98,29,7.995
2017-08-29 03:00:00+00:00,0,74,74,31,7.582
2017-08-29 04:00:00+00:00,6,57,63,38,7.22
2017-08-29 05:00:00+00:00,75,41,116,43,8.713
2017-08-29 06:00:00+00:00,202,22,224,44,10.629
2017-08-29 07:00:00+00:00,354,9,363,42,13.672
2017-08-29 08:00:00+00:00,488,4,492,39,16.125
2017-08-29 09:00:00+00:00,593,5,598,36,17.605
2017-08-29 10:00:00+00:00,656,7,663,33,18.571
2017-08-29 11:00:00+00:00,673,7,680,30,19.17
2017-08-29 12:00:00+00:00,644,11,655,30,19.407
2017-08-29 13:00:00+00:00,568,14,582,33,19.256
2017-08-29 14:00:00+00:00,450,21,471,36,18.7
2017-08-29 15:00:00+00:00,305,32,337,42,18.061
2017-08-29 16:00:00+00:00,157,49,206,46,18.337
2017-08-29 17:00:00+00:00,39,79,118,50,15.393
2017-08-29 18:00:00+00:00,3,189,192,48,13.768
2017-08-29 19:00:00+00:00,0,472,472,44,12.557
2017-08-29 20:00:00+00:00,0,573,573,39,11.546
2017-08-29 21:00:00+00:00,0,658,658,33,10.902
2017-08-29 22:00:00+00:00,0,720,720,32,10.524
2017-08-29 23:00:00+00:00,0,760,760,31,10.266
2017-08-30 00:00:00+00:00,0,688,688,30,9.969
2017-08-30 01:00:00+00:00,0,693,693,29,9.61
2017-08-30 02:00:00+00:00,0,813,813,30,9.345
2017-08-30 03:00:00+00:00,0,789,789,31,8.98
2017-08-30 04:00:00+00:00,5,809,814,37,8.671
2017-08-30 05:00:00+00:00,71,733,804,43,10.44
2017-08-30 06:00:00+00:00,197,484,681,45,13.262
2017-08-30 07:00:00+00:00,350,586,936,43,16.029
2017-08-30 08:00:00+00:00,491,835,1326,41,18.429
2017-08-30 09:00:00+00:00,592,1105,1697,38,19.885
2017-08-30 10:00:00+00:00,640,1100,1740,34,20.919
2017-08-30 11:00:00+00:00,651,1028,1679,34,21.583
2017-08-30 12:00:00+00:00,622,960,1582,33,21.847
2017-08-30 13:00:00+00:00,547,838,1385,34,21.723
2017-08-30 14:00:00+00:00,432,794,1226,37,21.194
2017-08-30 15:00:00+00:00,290,801,1091,41,21.737
2017-08-30 16:00:00+00:00,147,773,920,43,19.889
2017-08-30 17:00:00+00:00,35,776,811,44,16.196
2017-08-30 18:00:00+00:00,2,1021,1023,42,13.792
2017-08-30 19:00:00+00:00,0,1295,1295,39,12.643
2017-08-30 20:00:00+00:00,0,1284,1284,34,11.987
2017-08-30 21:00:00+00:00,0,1259,1259,31,11.669
2017-08-30 22:00:00+00:00,0,1272,1272,31,11.4
2017-08-30 23:00:00+00:00,0,1315,1315,29,11.122
2017-08-31 00:00:00+00:00,0,1301,1301,28,10.823
2017-08-31 01:00:00+00:00,0,1205,1205,28,10.561
2017-08-31 02:00:00+00:00,0,1113,1113,28,10.687
2017-08-31 03:00:00+00:00,0,896,896,30,10.897
2017-08-31 04:00:00+00:00,5,656,661,35,11.038
2017-08-31 05:00:00+00:00,65,424,489,42,12.494
2017-08-31 06:00:00+00:00,177,149,326,46,14.763
2017-08-31 07:00:00+00:00,315,92,407,46,17.376
2017-08-31 08:00:00+00:00,442,99,541,45,19.562
2017-08-31 09:00:00+00:00,543,148,691,43,20.819
2017-08-31 10:00:00+00:00,599,251,850,39,21.584
2017-08-31 11:00:00+00:00,608,412,1020,38,21.645
2017-08-31 12:00:00+00:00,575,491,1066,37,21.063
2017-08-31 13:00:00+00:00,493,564,1057,38,19.951
2017-08-31 14:00:00+00:00,381,538,919,40,18.605
2017-08-31 15:00:00+00:00,251,509,760,43,17.121
2017-08-31 16:00:00+00:00,124,255,379,45,15.973
2017-08-31 17:00:00+00:00,28,145,173,46,14.64
2017-08-31 18:00:00+00:00,1,140,141,45,13.565
2017-08-31 19:00:00+00:00,0,541,541,42,13.046
2017-08-31 20:00:00+00:00,0,1126,1126,38,12.186
2017-08-31 21:00:00+00:00,0,1299,1299,34,11.372
2017-08-31 22:00:00+00:00,0,1337,1337,32,10.73
2017-08-31 23:00:00+00:00,0,1280,1280,31,10.395
2017-09-01 00:00:00+00:00,0,1394,1394,31,10.218
2017-09-01 01:00:00+00:00,0,1213,1213,30,10.089
2017-09-01 02:00:00+00:00,0,1094,1094,30,10.002
2017-09-01 03:00:00+00:00,0,1122,1122,32,9.864
2017-09-01 04:00:00+00:00,3,888,891,37,9.72
2017-09-01 05:00:00+00:00,50,700,750,44,9.866
2017-09-01 06:00:00+00:00,131,642,773,47,10.305
2017-09-01 07:00:00+00:00,219,531,750,47,10.651
2017-09-01 08:00:00+00:00,295,552,847,47,11.157
2017-09-01 09:00:00+00:00,358,381,739,47,11.503
2017-09-01 10:00:00+00:00,386,360,746,45,11.543
2017-09-01 11:00:00+00:00,375,354,729,43,12.184
2017-09-01 12:00:00+00:00,331,557,888,41,12.766
2017-09-01 13:00:00+00:00,269,325,594,41,12.574
2017-09-01 14:00:00+00:00,208,415,623,41,12.006
2017-09-01 15:00:00+00:00,152,633,785,43,11.085
2017-09-01 16:00:00+00:00,85,1307,1392,45,10.343
2017-09-01 17:00:00+00:00,21,1734,1755,46,9.468
2017-09-01 18:00:00+00:00,1,1734,1735,45,8.688
2017-09-01 19:00:00+00:00,0,1886,1886,42,8
2017-09-01 20:00:00+00:00,0,1857,1857,39,7.502
2017-09-01 21:00:00+00:00,0,1769,1769,36,7.038
2017-09-01 22:00:00+00:00,0,1571,1571,34,6.6
2017-09-01 23:00:00+00:00,0,1460,1460,32,6.18
2017-09-02 00:00:00+00:00,0,1495,1495,31,5.805
2017-09-02 01:00:00+00:00,0,1339,1339,30,5.529
2017-09-02 02:00:00+00:00,0,1001,1001,29,5.287
2017-09-02 03:00:00+00:00,0,900,900,29,5.095
2017-09-02 04:00:00+00:00,3,932,935,30,4.944
2017-09-02 05:00:00+00:00,47,838,885,33,5.182
2017-09-02 06:00:00+00:00,123,627,750,36,5.773
2017-09-02 07:00:00+00:00,173,449,622,37,6.288
2017-09-02 08:00:00+00:00,232,471,703,37,6.825
2017-09-02 09:00:00+00:00,296,399,695,36,7.313
2017-09-02 10:00:00+00:00,386,326,712,33,7.512
2017-09-02 11:00:00+00:00,415,339,754,33,7.433
2017-09-02 12:00:00+00:00,379,406,785,31,7.334
2017-09-02 13:00:00+00:00,319,538,857,31,7.123
2017-09-02 14:00:00+00:00,239,756,995,32,6.636
2017-09-02 15:00:00+00:00,162,804,966,35,5.962
2017-09-02 16:00:00+00:00,86,783,869,40,5.071
2017-09-02 17:00:00+00:00,21,976,997,41,4.159
2017-09-02 18:00:00+00:00,1,1127,1128,41,3.361
2017-09-02 19:00:00+00:00,0,1098,1098,38,2.567
2017-09-02 20:00:00+00:00,0,1121,1121,37,1.97
2017-09-02 21:00:00+00:00,0,1179,1179,34,1.634
2017-09-02 22:00:00+00:00,0,1313,1313,31,1.309
2017-09-02 23:00:00+00:00,0,1330,1330,29,1.236
2017-09-03 00:00:00+00:00,0,1707,1707,27,1.206
2017-09-03 01:00:00+00:00,0,1655,1655,27,1.106
2017-09-03 02:00:00+00:00,0,1539,1539,28,1.097
2017-09-03 03:00:00+00:00,0,1524,1524,27,1.162
2017-09-03 04:00:00+00:00,2,1661,1663,27,1.259
2017-09-03 05:00:00+00:00,34,1765,1799,28,1.525
2017-09-03 06:00:00+00:00,98,1833,1931,30,2.076
2017-09-03 07:00:00+00:00,179,1902,2081,29,2.799
2017-09-03 08:00:00+00:00,261,1930,2191,27,3.447
2017-09-03 09:00:00+00:00,322,1937,2259,27,3.966
2017-09-03 10:00:00+00:00,335,1939,2274,26,4.708
2017-09-03 11:00:00+00:00,369,2047,2416,24,5.528
2017-09-03 12:00:00+00:00,364,2179,2543,23,6.147
2017-09-03 13:00:00+00:00,325,2063,2388,24,6.542
2017-09-03 14:00:00+00:00,270,1779,2049,27,6.58
2017-09-03 15:00:00+00:00,187,1538,1725,31,6.228
2017-09-03 16:00:00+00:00,100,1367,1467,36,5.567
2017-09-03 17:00:00+00:00,25,1062,1087,42,4.111
2017-09-03 18:00:00+00:00,1,1261,1262,42,3.404
2017-09-03 19:00:00+00:00,0,1649,1649,40,3.178
2017-09-03 20:00:00+00:00,0,1754,1754,38,3.044
2017-09-03 21:00:00+00:00,0,1805,1805,34,2.845
2017-09-03 22:00:00+00:00,0,1695,1695,31,2.396
2017-09-03 23:00:00+00:00,0,1706,1706,29,1.703
2017-09-04 00:00:00+00:00,0,1747,1747,28,1.18
2017-09-04 01:00:00+00:00,0,1549,1549,27,0.819
2017-09-04 02:00:00+00:00,0,1404,1404,27,0.562
2017-09-04 03:00:00+00:00,0,1204,1204,29,0.23
2017-09-04 04:00:00+00:00,4,1210,1214,40,-0.18
2017-09-04 05:00:00+00:00,63,930,993,44,1.373
2017-09-04 06:00:00+00:00,180,625,805,46,4.084
2017-09-04 07:00:00+00:00,332,557,889,44,7.269
2017-09-04 08:00:00+00:00,477,472,949,41,10.562
2017-09-04 09:00:00+00:00,587,496,1083,40,11.179
2017-09-04 10:00:00+00:00,644,473,1117,37,11.717
2017-09-04 11:00:00+00:00,651,450,1101,37,12.245
2017-09-04 12:00:00+00:00,612,350,962,35,12.443
2017-09-04 13:00:00+00:00,531,324,855,38,12.277
2017-09-04 14:00:00+00:00,411,268,679,39,11.747
2017-09-04 15:00:00+00:00,269,241,510,42,10.896
2017-09-04 16:00:00+00:00,132,222,354,45,9.703
2017-09-04 17:00:00+00:00,31,224,255,48,7.629
2017-09-04 18:00:00+00:00,2,221,223,48,6.925
2017-09-04 19:00:00+00:00,0,271,271,44,6.48
2017-09-04 20:00:00+00:00,0,352,352,39,5.924
2017-09-04 21:00:00+00:00,0,415,415,33,5.323
2017-09-04 22:00:00+00:00,0,433,433,32,5.003
2017-09-04 23:00:00+00:00,0,452,452,31,4.791
2017-09-05 00:00:00+00:00,0,472,472,30,4.58
2017-09-05 01:00:00+00:00,0,545,545,29,4.513
2017-09-05 02:00:00+00:00,0,537,537,29,4.368
2017-09-05 03:00:00+00:00,0,548,548,32,4.139
2017-09-05 04:00:00+00:00,4,570,574,39,3.933
2017-09-05 05:00:00+00:00,60,507,567,45,5.089
2017-09-05 06:00:00+00:00,173,396,569,46,7.198
2017-09-05 07:00:00+00:00,318,355,673,45,8.655
2017-09-05 08:00:00+00:00,465,358,823,42,10.089
2017-09-05 09:00:00+00:00,562,539,1101,39,11.274
2017-09-05 10:00:00+00:00,625,798,1423,36,12.168
2017-09-05 11:00:00+00:00,644,1028,1672,36,12.817
2017-09-05 12:00:00+00:00,618,1014,1632,36,13.393
2017-09-05 13:00:00+00:00,544,960,1504,37,13.822
2017-09-05 14:00:00+00:00,420,934,1354,39,13.537
2017-09-05 15:00:00+00:00,270,917,1187,42,12.91
2017-09-05 16:00:00+00:00,129,877,1006,45,11.888
2017-09-05 17:00:00+00:00,28,939,967,47,9.947
2017-09-05 18:00:00+00:00,1,1119,1120,46,9.154
2017-09-05 19:00:00+00:00,0,1157,1157,42,8.623
2017-09-05 20:00:00+00:00,0,1153,1153,38,8.204
2017-09-05 21:00:00+00:00,0,1063,1063,32,8.148
2017-09-05 22:00:00+00:00,0,923,923,31,8.176
2017-09-05 23:00:00+00:00,0,828,828,29,8.128
2017-09-06 00:00:00+00:00,0,749,749,29,7.981
2017-09-06 01:00:00+00:00,0,644,644,27,7.796
2017-09-06 02:00:00+00:00,0,500,500,28,7.833
2017-09-06 03:00:00+00:00,0,368,368,30,7.908
2017-09-06 04:00:00+00:00,2,290,292,36,7.953
2017-09-06 05:00:00+00:00,45,171,216,42,8.609
2017-09-06 06:00:00+00:00,115,90,205,45,9.953
2017-09-06 07:00:00+00:00,211,60,271,44,10.851
2017-09-06 08:00:00+00:00,307,77,384,42,11.637
2017-09-06 09:00:00+00:00,375,100,475,41,12.254
2017-09-06 10:00:00+00:00,427,233,660,37,13.178
2017-09-06 11:00:00+00:00,465,285,750,34,13.831
2017-09-06 12:00:00+00:00,454,278,732,32,14.04
2017-09-06 13:00:00+00:00,380,274,654,31,13.909
2017-09-06 14:00:00+00:00,299,674,973,30,13.46
2017-09-06 15:00:00+00:00,201,1199,1400,32,12.764
2017-09-06 16:00:00+00:00,104,912,1016,34,11.826
2017-09-06 17:00:00+00:00,24,1123,1147,36,10.306
2017-09-06 18:00:00+00:00,1,1168,1169,37,9.47
2017-09-06 19:00:00+00:00,0,1271,1271,33,9.005
2017-09-06 20:00:00+00:00,0,1391,1391,30,8.435
2017-09-06 21:00:00+00:00,0,1329,1329,26,8.086
2017-09-06 22:00:00+00:00,0,1409,1409,20,7.605
2017-09-06 23:00:00+00:00,0,1593,1593,19,7.163
2017-09-07 00:00:00+00:00,0,1687,1687,16,6.574
2017-09-07 01:00:00+00:00,0,1644,1644,15,6.135
2017-09-07 02:00:00+00:00,0,1544,1544,17,5.903
2017-09-07 03:00:00+00:00,0,1369,1369,23,5.725
2017-09-07 04:00:00+00:00,2,930,932,33,5.428
2017-09-07 05:00:00+00:00,45,890,935,39,5.668
2017-09-07 06:00:00+00:00,128,1018,1146,40,6.133
2017-09-07 07:00:00+00:00,247,1269,1516,39,7.006
2017-09-07 08:00:00+00:00,366,1626,1992,37,8.27
2017-09-07 09:00:00+00:00,460,1505,1965,36,9.669
2017-09-07 10:00:00+00:00,526,1330,1856,35,10.806
2017-09-07 11:00:00+00:00,556,1150,1706,34,11.707
2017-09-07 12:00:00+00:00,537,1178,1715,32,12.276
2017-09-07 13:00:00+00:00,468,1121,1589,33,12.289
2017-09-07 14:00:00+00:00,363,1039,1402,34,11.63
2017-09-07 15:00:00+00:00,242,848,1090,37,10.463
2017-09-07 16:00:00+00:00,119,484,603,42,9.185
2017-09-07 17:00:00+00:00,26,289,315,46,7.775
2017-09-07 18:00:00+00:00,1,332,333,46,7.179
2017-09-07 19:00:00+00:00,0,316,316,42,6.719
2017-09-07 20:00:00+00:00,0,277,277,38,6.211
2017-09-07 21:00:00+00:00,0,165,165,33,5.852
2017-09-07 22:00:00+00:00,0,91,91,29,5.474
2017-09-07 23:00:00+00:00,0,53,53,25,5.181
2017-09-08 00:00:00+00:00,0,47,47,21,4.979
2017-09-08 01:00:00+00:00,0,52,52,20,4.789
2017-09-08 02:00:00+00:00,0,37,37,22,4.676
2017-09-08 03:00:00+00:00,0,31,31,24,4.591
2017-09-08 04:00:00+00:00,3,54,57,33,4.444
2017-09-08 05:00:00+00:00,57,50,107,38,5.225
2017-09-08 06:00:00+00:00,173,31,204,36,7.266
2017-09-08 07:00:00+00:00,330,36,366,34,9.812
2017-09-08 08:00:00+00:00,482,125,607,31,12.029
2017-09-08 09:00:00+00:00,599,357,956,29,13.819
2017-09-08 10:00:00+00:00,669,754,1423,25,14.949
2017-09-08 11:00:00+00:00,688,1026,1714,23,15.602
2017-09-08 12:00:00+00:00,651,1232,1883,22,15.771
2017-09-08 13:00:00+00:00,562,1405,1967,23,15.462
2017-09-08 14:00:00+00:00,428,1487,1915,25,14.688
2017-09-08 15:00:00+00:00,265,1594,1859,30,13.416
2017-09-08 16:00:00+00:00,118,1639,1757,34,11.855
2017-09-08 17:00:00+00:00,24,1467,1491,37,9.973
2017-09-08 18:00:00+00:00,1,1402,1403,39,8.719
2017-09-08 19:00:00+00:00,0,1444,1444,35,8.078
2017-09-08 20:00:00+00:00,0,1388,1388,33,7.751
2017-09-08 21:00:00+00:00,0,1304,1304,28,7.569
2017-09-08 22:00:00+00:00,0,1360,1360,21,7.323
2017-09-08 23:00:00+00:00,0,1355,1355,20,7.076
2017-09-09 00:00:00+00:00,0,1435,1435,16,6.845
2017-09-09 01:00:00+00:00,0,1303,1303,16,6.645
2017-09-09 02:00:00+00:00,0,1191,1191,15,6.482
2017-09-09 03:00:00+00:00,0,1128,1128,18,6.352
2017-09-09 04:00:00+00:00,2,1079,1081,23,6.238
2017-09-09 05:00:00+00:00,54,1130,1184,27,7.226
2017-09-09 06:00:00+00:00,163,1193,1356,32,8.87
2017-09-09 07:00:00+00:00,311,1353,1664,34,10.686
2017-09-09 08:00:00+00:00,449,1547,1996,34,12.475
2017-09-09 09:00:00+00:00,547,1929,2476,34,13.726
2017-09-09 10:00:00+00:00,599,2095,2694,33,14.422
2017-09-09 11:00:00+00:00,609,2097,2706,30,14.897
2017-09-09 12:00:00+00:00,575,2050,2625,29,14.701
2017-09-09 13:00:00+00:00,496,2046,2542,29,14.095
2017-09-09 14:00:00+00:00,380,1938,2318,30,13.257
2017-09-09 15:00:00+00:00,236,1718,1954,34,12.181
2017-09-09 16:00:00+00:00,98,1397,1495,37,11.014
2017-09-09 17:00:00+00:00,17,1242,1259,40,9.757
2017-09-09 18:00:00+00:00,0,1257,1257,39,9.186
2017-09-09 19:00:00+00:00,0,1157,1157,36,8.941
2017-09-09 20:00:00+00:00,0,1084,1084,35,8.611
2017-09-09 21:00:00+00:00,0,951,951,32,8.336
2017-09-09 22:00:00+00:00,0,715,715,30,8.148
2017-09-09 23:00:00+00:00,0,613,613,26,8.015
2017-09-10 00:00:00+00:00,0,509,509,25,7.962
2017-09-10 01:00:00+00:00,0,404,404,25,7.827
2017-09-10 02:00:00+00:00,0,243,243,25,7.782
2017-09-10 03:00:00+00:00,0,254,254,25,7.8
2017-09-10 04:00:00+00:00,2,266,268,27,7.802
2017-09-10 05:00:00+00:00,41,228,269,28,8.034
2017-09-10 06:00:00+00:00,117,227,344,29,8.509
2017-09-10 07:00:00+00:00,216,262,478,29,8.656
2017-09-10 08:00:00+00:00,313,218,531,27,8.631
2017-09-10 09:00:00+00:00,387,217,604,26,8.729
2017-09-10 10:00:00+00:00,428,135,563,23,8.998
2017-09-10 11:00:00+00:00,429,158,587,21,9.293
2017-09-10 12:00:00+00:00,406,149,555,21,9.604
2017-09-10 13:00:00+00:00,361,160,521,20,9.612
2017-09-10 14:00:00+00:00,282,179,461,19,9.415
2017-09-10 15:00:00+00:00,182,171,353,24,8.927
2017-09-10 16:00:00+00:00,84,146,230,27,8.448
2017-09-10 17:00:00+00:00,16,168,184,32,7.802
2017-09-10 18:00:00+00:00,0,138,138,33,7.555
2017-09-10 19:00:00+00:00,0,135,135,30,7.45
2017-09-10 20:00:00+00:00,0,272,272,28,7.189
2017-09-10 21:00:00+00:00,0,347,347,23,7.026
2017-09-10 22:00:00+00:00,0,420,420,18,6.708
2017-09-10 23:00:00+00:00,0,362,362,14,6.501
2017-09-11 00:00:00+00:00,0,245,245,12,6.368
2017-09-11 01:00:00+00:00,0,177,177,11,6.188
2017-09-11 02:00:00+00:00,0,108,108,12,6.112
2017-09-11 03:00:00+00:00,0,122,122,16,6.137
2017-09-11 04:00:00+00:00,1,102,103,31,6.202
2017-09-11 05:00:00+00:00,30,75,105,37,6.803
2017-09-11 06:00:00+00:00,86,42,128,37,7.85
2017-09-11 07:00:00+00:00,172,47,219,35,9.061
2017-09-11 08:00:00+00:00,245,61,306,34,10.409
2017-09-11 09:00:00+00:00,304,85,389,34,11.233
2017-09-11 10:00:00+00:00,343,87,430,31,11.668
2017-09-11 11:00:00+00:00,328,212,540,30,11.658
2017-09-11 12:00:00+00:00,289,165,454,30,11.516
2017-09-11 13:00:00+00:00,253,100,353,30,11.371
2017-09-11 14:00:00+00:00,185,81,266,31,10.839
2017-09-11 15:00:00+00:00,99,134,233,34,10.042
2017-09-11 16:00:00+00:00,43,320,363,37,9.279
2017-09-11 17:00:00+00:00,8,621,629,39,8.134
2017-09-11 18:00:00+00:00,0,1318,1318,43,7.551
2017-09-11 19:00:00+00:00,0,1649,1649,38,6.952
2017-09-11 20:00:00+00:00,0,1560,1560,34,6.414
2017-09-11 21:00:00+00:00,0,1540,1540,29,5.857
2017-09-11 22:00:00+00:00,0,1681,1681,9,5.368
2017-09-11 23:00:00+00:00,0,1798,1798,8,4.981
2017-09-12 00:00:00+00:00,0,1923,1923,8,4.623
2017-09-12 01:00:00+00:00,0,1966,1966,7,4.387
2017-09-12 02:00:00+00:00,0,1945,1945,10,4.027
2017-09-12 03:00:00+00:00,0,1712,1712,18,3.693
2017-09-12 04:00:00+00:00,1,1188,1189,31,3.459
2017-09-12 05:00:00+00:00,41,1027,1068,39,3.656
2017-09-12 06:00:00+00:00,120,856,976,39,4.164
2017-09-12 07:00:00+00:00,220,866,1086,37,4.542
2017-09-12 08:00:00+00:00,314,886,1200,34,5.058
2017-09-12 09:00:00+00:00,375,985,1360,31,5.455
2017-09-12 10:00:00+00:00,406,1210,1616,28,5.904
2017-09-12 11:00:00+00:00,408,1455,1863,29,6.003
2017-09-12 12:00:00+00:00,373,1621,1994,26,5.128
2017-09-12 13:00:00+00:00,323,1499,1822,27,4.633
2017-09-12 14:00:00+00:00,248,1113,1361,29,4.642
2017-09-12 15:00:00+00:00,157,887,1044,36,5.066
2017-09-12 16:00:00+00:00,72,515,587,41,4.902
2017-09-12 17:00:00+00:00,13,531,544,44,3.054
2017-09-12 18:00:00+00:00,0,1044,1044,44,1.893
2017-09-12 19:00:00+00:00,0,1268,1268,39,1.777
2017-09-12 20:00:00+00:00,0,1439,1439,35,1.727
2017-09-12 21:00:00+00:00,0,1500,1500,27,1.617
2017-09-12 22:00:00+00:00,0,1451,1451,19,1.475
2017-09-12 23:00:00+00:00,0,1407,1407,14,1.341
2017-09-13 00:00:00+00:00,0,1403,1403,10,1.234
2017-09-13 01:00:00+00:00,0,1292,1292,5,1.178
2017-09-13 02:00:00+00:00,0,1255,1255,5,1.183
2017-09-13 03:00:00+00:00,0,1133,1133,9,0.807
2017-09-13 04:00:00+00:00,2,787,789,20,0.056
2017-09-13 05:00:00+00:00,51,453,504,26,1.024
2017-09-13 06:00:00+00:00,159,267,426,26,2.991
2017-09-13 07:00:00+00:00,303,270,573,25,5.015
2017-09-13 08:00:00+00:00,435,529,964,22,7.081
2017-09-13 09:00:00+00:00,525,941,1466,19,9.73
2017-09-13 10:00:00+00:00,581,1576,2157,12,11.643
2017-09-13 11:00:00+00:00,566,1904,2470,10,13.465
2017-09-13 12:00:00+00:00,509,1955,2464,5,14.448
2017-09-13 13:00:00+00:00,424,1901,2325,9,14.608
2017-09-13 14:00:00+00:00,298,1714,2012,10,14.438
2017-09-13 15:00:00+00:00,174,1469,1643,16,13.126
2017-09-13 16:00:00+00:00,77,1174,1251,22,11.473
2017-09-13 17:00:00+00:00,14,1072,1086,26,9.076
2017-09-13 18:00:00+00:00,0,1052,1052,26,8.384
2017-09-13 19:00:00+00:00,0,1106,1106,20,7.774
2017-09-13 20:00:00+00:00,0,1034,1034,10,7.122
2017-09-13 21:00:00+00:00,0,939,939,-5,7.148
2017-09-13 22:00:00+00:00,0,940,940,-9,7.085
2017-09-13 23:00:00+00:00,0,997,997,-10,6.739
2017-09-14 00:00:00+00:00,0,795,795,-11,6.493
2017-09-14 01:00:00+00:00,0,704,704,-8,6.412
2017-09-14 02:00:00+00:00,0,838,838,0,6.478
2017-09-14 03:00:00+00:00,0,943,943,10,6.387
2017-09-14 04:00:00+00:00,2,1001,1003,29,6.364
2017-09-14 05:00:00+00:00,47,966,1013,38,6.882
2017-09-14 06:00:00+00:00,147,767,914,37,8.001
2017-09-14 07:00:00+00:00,295,716,1011,36,9.749
2017-09-14 08:00:00+00:00,449,754,1203,33,11.465
2017-09-14 09:00:00+00:00,566,763,1329,33,12.664
2017-09-14 10:00:00+00:00,629,967,1596,30,12.958
2017-09-14 11:00:00+00:00,632,1155,1787,28,13.058
2017-09-14 12:00:00+00:00,583,1302,1885,28,13.042
2017-09-14 13:00:00+00:00,490,1284,1774,27,12.5
2017-09-14 14:00:00+00:00,353,1735,2088,27,10.626
2017-09-14 15:00:00+00:00,200,2415,2615,31,8.181
2017-09-14 16:00:00+00:00,77,2511,2588,35,6.315
2017-09-14 17:00:00+00:00,11,2459,2470,38,4.435
2017-09-14 18:00:00+00:00,0,2204,2204,37,2.884
2017-09-14 19:00:00+00:00,0,2304,2304,32,2.012
2017-09-14 20:00:00+00:00,0,2282,2282,27,1.284
2017-09-14 21:00:00+00:00,0,1999,1999,20,0.605
2017-09-14 22:00:00+00:00,0,1658,1658,17,0.164
2017-09-14 23:00:00+00:00,0,1641,1641,15,-0.551
2017-09-15 00:00:00+00:00,0,1552,1552,14,-0.694
2017-09-15 01:00:00+00:00,0,1437,1437,13,-0.791
2017-09-15 02:00:00+00:00,0,1262,1262,16,-0.952
2017-09-15 03:00:00+00:00,0,1094,1094,23,-0.934
2017-09-15 04:00:00+00:00,1,995,996,37,-0.524
2017-09-15 05:00:00+00:00,48,956,1004,44,0.853
2017-09-15 06:00:00+00:00,157,769,926,45,3.144
2017-09-15 07:00:00+00:00,309,633,942,41,5.262
2017-09-15 08:00:00+00:00,453,395,848,39,5.872
2017-09-15 09:00:00+00:00,560,283,843,39,6.7
2017-09-15 10:00:00+00:00,622,410,1032,37,7.526
2017-09-15 11:00:00+00:00,628,543,1171,36,8.306
2017-09-15 12:00:00+00:00,575,745,1320,35,8.727
2017-09-15 13:00:00+00:00,490,923,1413,36,8.828
2017-09-15 14:00:00+00:00,369,1232,1601,36,8.464
2017-09-15 15:00:00+00:00,219,1146,1365,40,7.858
2017-09-15 16:00:00+00:00,88,1151,1239,44,7.019
2017-09-15 17:00:00+00:00,14,1197,1211,47,5.683
2017-09-15 18:00:00+00:00,0,950,950,47,5.25
2017-09-15 19:00:00+00:00,0,759,759,43,5.065
2017-09-15 20:00:00+00:00,0,601,601,40,4.848
2017-09-15 21:00:00+00:00,0,520,520,36,4.694
2017-09-15 22:00:00+00:00,0,490,490,33,4.565
2017-09-15 23:00:00+00:00,0,441,441,32,4.332
2017-09-16 00:00:00+00:00,0,384,384,31,3.945
2017-09-16 01:00:00+00:00,0,414,414,30,3.223
2017-09-16 02:00:00+00:00,0,526,526,30,2.361
2017-09-16 03:00:00+00:00,0,323,323,32,1.988
2017-09-16 04:00:00+00:00,0,301,301,34,1.952
2017-09-16 05:00:00+00:00,30,426,456,36,2.467
2017-09-16 06:00:00+00:00,98,522,620,39,3.295
2017-09-16 07:00:00+00:00,194,596,790,40,4.524
2017-09-16 08:00:00+00:00,276,662,938,40,5.997
2017-09-16 09:00:00+00:00,339,627,966,39,6.654
2017-09-16 10:00:00+00:00,395,572,967,37,7.073
2017-09-16 11:00:00+00:00,428,522,950,34,7.483
2017-09-16 12:00:00+00:00,422,384,806,34,7.738
2017-09-16 13:00:00+00:00,364,327,691,34,7.77
2017-09-16 14:00:00+00:00,265,360,625,36,7.885
2017-09-16 15:00:00+00:00,160,281,441,39,7.656
2017-09-16 16:00:00+00:00,68,279,347,42,6.776
2017-09-16 17:00:00+00:00,11,241,252,46,5.552
2017-09-16 18:00:00+00:00,0,294,294,47,5.515
2017-09-16 19:00:00+00:00,0,301,301,42,5.398
2017-09-16 20:00:00+00:00,0,244,244,40,5.113
2017-09-16 21:00:00+00:00,0,260,260,36,4.954
2017-09-16 22:00:00+00:00,0,320,320,34,4.611
2017-09-16 23:00:00+00:00,0,397,397,32,4.433
2017-09-17 00:00:00+00:00,0,316,316,31,4.239
2017-09-17 01:00:00+00:00,0,294,294,29,4.07
2017-09-17 02:00:00+00:00,0,277,277,29,3.889
2017-09-17 03:00:00+00:00,0,335,335,29,3.765
2017-09-17 04:00:00+00:00,0,459,459,32,3.659
2017-09-17 05:00:00+00:00,24,305,329,30,3.782
2017-09-17 06:00:00+00:00,74,207,281,35,4.239
2017-09-17 07:00:00+00:00,133,408,541,35,5.062
2017-09-17 08:00:00+00:00,199,642,841,33,5.674
2017-09-17 09:00:00+00:00,269,729,998,33,6.211
2017-09-17 10:00:00+00:00,316,676,992,32,6.617
2017-09-17 11:00:00+00:00,344,778,1122,28,6.899
2017-09-17 12:00:00+00:00,320,1155,1475,27,6.949
2017-09-17 13:00:00+00:00,246,1479,1725,28,6.417
2017-09-17 14:00:00+00:00,195,1378,1573,30,5.663
2017-09-17 15:00:00+00:00,130,1303,1433,34,4.814
2017-09-17 16:00:00+00:00,56,969,1025,40,3.925
2017-09-17 17:00:00+00:00,9,753,762,44,3.229
2017-09-17 18:00:00+00:00,0,760,760,43,2.776
2017-09-17 19:00:00+00:00,0,883,883,41,2.401
2017-09-17 20:00:00+00:00,0,948,948,38,2.064
2017-09-17 21:00:00+00:00,0,869,869,35,1.882
2017-09-17 22:00:00+00:00,0,690,690,34,1.677
2017-09-17 23:00:00+00:00,0,504,504,30,1.381
2017-09-18 00:00:00+00:00,0,290,290,30,1.051
2017-09-18 01:00:00+00:00,0,179,179,28,0.896
2017-09-18 02:00:00+00:00,0,125,125,29,0.946
2017-09-18 03:00:00+00:00,0,107,107,32,1.199
2017-09-18 04:00:00+00:00,0,75,75,44,1.581
2017-09-18 05:00:00+00:00,36,67,103,51,2.079
2017-09-18 06:00:00+00:00,119,57,176,54,3.629
2017-09-18 07:00:00+00:00,241,41,282,51,5.06
2017-09-18 08:00:00+00:00,369,45,414,47,6.508
2017-09-18 09:00:00+00:00,468,78,546,46,7.167
2017-09-18 10:00:00+00:00,513,83,596,42,7.995
2017-09-18 11:00:00+00:00,511,74,585,40,8.804
2017-09-18 12:00:00+00:00,484,86,570,39,9.001
2017-09-18 13:00:00+00:00,412,88,500,40,8.334
2017-09-18 14:00:00+00:00,301,73,374,42,7.144
2017-09-18 15:00:00+00:00,180,26,206,45,6.049
2017-09-18 16:00:00+00:00,74,20,94,49,5.069
2017-09-18 17:00:00+00:00,11,30,41,52,4.313
2017-09-18 18:00:00+00:00,0,43,43,54,3.744
2017-09-18 19:00:00+00:00,0,32,32,44,3.315
2017-09-18 20:00:00+00:00,0,36,36,40,2.848
2017-09-18 21:00:00+00:00,0,41,41,36,2.293
2017-09-18 22:00:00+00:00,0,56,56,36,1.935
2017-09-18 23:00:00+00:00,0,93,93,34,1.648
2017-09-19 00:00:00+00:00,0,130,130,31,1.403
2017-09-19 01:00:00+00:00,0,150,150,30,1.225
2017-09-19 02:00:00+00:00,0,149,149,31,1.12
2017-09-19 03:00:00+00:00,0,172,172,34,1.089
2017-09-19 04:00:00+00:00,0,193,193,45,1.02
2017-09-19 05:00:00+00:00,26,277,303,53,1.005
2017-09-19 06:00:00+00:00,76,327,403,56,1.091
2017-09-19 07:00:00+00:00,144,403,547,54,1.361
2017-09-19 08:00:00+00:00,220,473,693,52,1.642
2017-09-19 09:00:00+00:00,274,498,772,49,1.966
2017-09-19 10:00:00+00:00,291,494,785,45,2.104
2017-09-19 11:00:00+00:00,271,542,813,43,2.244
2017-09-19 12:00:00+00:00,256,590,846,42,2.35
2017-09-19 13:00:00+00:00,215,688,903,43,2.384
2017-09-19 14:00:00+00:00,157,918,1075,43,2.292
2017-09-19 15:00:00+00:00,98,1056,1154,46,2.131
2017-09-19 16:00:00+00:00,45,958,1003,49,1.949
2017-09-19 17:00:00+00:00,7,991,998,52,1.795
2017-09-19 18:00:00+00:00,0,1045,1045,51,1.779
2017-09-19 19:00:00+00:00,0,1063,1063,43,1.767
2017-09-19 20:00:00+00:00,0,1148,1148,38,1.763
2017-09-19 21:00:00+00:00,0,1210,1210,34,1.771
2017-09-19 22:00:00+00:00,0,1443,1443,32,1.755
2017-09-19 23:00:00+00:00,0,1605,1605,30,1.67
2017-09-20 00:00:00+00:00,0,1776,1776,29,1.613
2017-09-20 01:00:00+00:00,0,2004,2004,29,1.56
2017-09-20 02:00:00+00:00,0,2176,2176,29,1.546
2017-09-20 03:00:00+00:00,0,2263,2263,31,1.583
2017-09-20 04:00:00+00:00,0,2367,2367,39,1.623
2017-09-20 05:00:00+00:00,26,2451,2477,47,1.728
2017-09-20 06:00:00+00:00,85,2453,2538,51,2.037
2017-09-20 07:00:00+00:00,169,2450,2619,48,2.384
2017-09-20 08:00:00+00:00,263,2424,2687,47,2.761
2017-09-20 09:00:00+00:00,350,2406,2756,45,3.159
2017-09-20 10:00:00+00:00,396,2281,2677,41,3.636
2017-09-20 11:00:00+00:00,392,2170,2562,39,4.163
2017-09-20 12:00:00+00:00,342,1990,2332,38,4.531
2017-09-20 13:00:00+00:00,291,1830,2121,37,4.733
2017-09-20 14:00:00+00:00,222,1817,2039,38,4.645
2017-09-20 15:00:00+00:00,142,1886,2028,43,4.19
2017-09-20 16:00:00+00:00,63,1748,1811,46,3.205
2017-09-20 17:00:00+00:00,9,1762,1771,51,1.905
2017-09-20 18:00:00+00:00,0,1603,1603,49,1.804
2017-09-20 19:00:00+00:00,0,1519,1519,42,1.725
2017-09-20 20:00:00+00:00,0,1650,1650,39,1.538
2017-09-20 21:00:00+00:00,0,1779,1779,35,1.39
2017-09-20 22:00:00+00:00,0,1975,1975,33,1.257
2017-09-20 23:00:00+00:00,0,2246,2246,32,1.217
2017-09-21 00:00:00+00:00,0,2182,2182,30,1.187
2017-09-21 01:00:00+00:00,0,2192,2192,29,1.134
2017-09-21 02:00:00+00:00,0,2243,2243,29,1.095
2017-09-21 03:00:00+00:00,0,2299,2299,32,0.979
2017-09-21 04:00:00+00:00,0,2259,2259,41,0.825
2017-09-21 05:00:00+00:00,30,2252,2282,49,1.15
2017-09-21 06:00:00+00:00,108,2260,2368,51,2.455
2017-09-21 07:00:00+00:00,233,2176,2409,49,3.39
2017-09-21 08:00:00+00:00,358,2143,2501,47,4.524
2017-09-21 09:00:00+00:00,449,2204,2653,44,5.816
2017-09-21 10:00:00+00:00,466,2253,2719,39,7.097
2017-09-21 11:00:00+00:00,473,2170,2643,37,8.073
2017-09-21 12:00:00+00:00,441,2063,2504,36,8.554
2017-09-21 13:00:00+00:00,383,1932,2315,38,8.652
2017-09-21 14:00:00+00:00,289,1787,2076,40,8.368
2017-09-21 15:00:00+00:00,174,1705,1879,45,7.568
2017-09-21 16:00:00+00:00,70,1726,1796,49,5.744
2017-09-21 17:00:00+00:00,10,1700,1710,53,3.669
2017-09-21 18:00:00+00:00,0,1659,1659,51,3.253
2017-09-21 19:00:00+00:00,0,1494,1494,43,2.965
2017-09-21 20:00:00+00:00,0,1517,1517,39,2.429
2017-09-21 21:00:00+00:00,0,1748,1748,33,1.841
2017-09-21 22:00:00+00:00,0,1620,1620,33,1.429
2017-09-21 23:00:00+00:00,0,1507,1507,31,1.261
2017-09-22 00:00:00+00:00,0,1381,1381,30,0.971
2017-09-22 01:00:00+00:00,0,1292,1292,30,0.507
2017-09-22 02:00:00+00:00,0,1281,1281,31,-0.275
2017-09-22 03:00:00+00:00,0,1236,1236,32,-0.613
2017-09-22 04:00:00+00:00,0,1139,1139,42,-0.677
2017-09-22 05:00:00+00:00,31,1139,1170,50,-0.005
2017-09-22 06:00:00+00:00,110,993,1103,51,3.184
2017-09-22 07:00:00+00:00,234,822,1056,48,5.733
2017-09-22 08:00:00+00:00,365,728,1093,46,8.648
2017-09-22 09:00:00+00:00,466,601,1067,43,10.53
2017-09-22 10:00:00+00:00,514,457,971,39,11.816
2017-09-22 11:00:00+00:00,511,431,942,38,12.604
2017-09-22 12:00:00+00:00,465,449,914,34,12.948
2017-09-22 13:00:00+00:00,390,306,696,35,12.731
2017-09-22 14:00:00+00:00,286,327,613,36,11.933
2017-09-22 15:00:00+00:00,169,436,605,42,10.81
2017-09-22 16:00:00+00:00,65,479,544,47,9.076
2017-09-22 17:00:00+00:00,9,597,606,50,7.528
2017-09-22 18:00:00+00:00,0,874,874,48,6.729
2017-09-22 19:00:00+00:00,0,969,969,42,5.727
2017-09-22 20:00:00+00:00,0,657,657,39,4.779
2017-09-22 21:00:00+00:00,0,545,545,35,4.191
2017-09-22 22:00:00+00:00,0,577,577,36,3.803
2017-09-22 23:00:00+00:00,0,619,619,34,3.387
2017-09-23 00:00:00+00:00,0,623,623,33,2.901
2017-09-23 01:00:00+00:00,0,672,672,32,2.525
2017-09-23 02:00:00+00:00,0,754,754,32,2.273
2017-09-23 03:00:00+00:00,0,803,803,33,2.262
2017-09-23 04:00:00+00:00,0,886,886,35,2.299
2017-09-23 05:00:00+00:00,33,923,956,37,2.632
2017-09-23 06:00:00+00:00,117,804,921,42,4.511
2017-09-23 07:00:00+00:00,255,675,930,42,6.613
2017-09-23 08:00:00+00:00,400,612,1012,41,9.465
2017-09-23 09:00:00+00:00,505,542,1047,37,11.544
2017-09-23 10:00:00+00:00,550,442,992,35,12.784
2017-09-23 11:00:00+00:00,544,395,939,34,13.381
2017-09-23 12:00:00+00:00,490,369,859,33,13.421
2017-09-23 13:00:00+00:00,404,332,736,34,12.98
2017-09-23 14:00:00+00:00,289,402,691,35,12.096
2017-09-23 15:00:00+00:00,161,554,715,39,11.011
2017-09-23 16:00:00+00:00,56,677,733,44,9.326
2017-09-23 17:00:00+00:00,6,763,769,47,7.743
2017-09-23 18:00:00+00:00,0,757,757,45,7.282
2017-09-23 19:00:00+00:00,0,496,496,41,7.068
2017-09-23 20:00:00+00:00,0,408,408,38,6.831
2017-09-23 21:00:00+00:00,0,395,395,34,6.631
2017-09-23 22:00:00+00:00,0,335,335,32,6.395
2017-09-23 23:00:00+00:00,0,320,320,31,6.18
2017-09-24 00:00:00+00:00,0,289,289,30,5.966
2017-09-24 01:00:00+00:00,0,229,229,30,5.689
2017-09-24 02:00:00+00:00,0,215,215,30,5.439
2017-09-24 03:00:00+00:00,0,284,284,29,5.135
2017-09-24 04:00:00+00:00,0,259,259,30,4.834
2017-09-24 05:00:00+00:00,27,256,283,31,4.774
2017-09-24 06:00:00+00:00,88,215,303,33,5.563
2017-09-24 07:00:00+00:00,184,184,368,34,6.572
2017-09-24 08:00:00+00:00,289,143,432,35,7.495
2017-09-24 09:00:00+00:00,372,118,490,35,7.972
2017-09-24 10:00:00+00:00,418,88,506,35,8.016
2017-09-24 11:00:00+00:00,422,69,491,33,7.91
2017-09-24 12:00:00+00:00,381,60,441,32,7.833
2017-09-24 13:00:00+00:00,296,83,379,32,7.706
2017-09-24 14:00:00+00:00,190,72,262,31,7.436
2017-09-24 15:00:00+00:00,107,58,165,33,6.968
2017-09-24 16:00:00+00:00,43,79,122,40,6.33
2017-09-24 17:00:00+00:00,5,73,78,43,5.651
2017-09-24 18:00:00+00:00,0,36,36,44,5.394
2017-09-24 19:00:00+00:00,0,19,19,39,5.288
2017-09-24 20:00:00+00:00,0,11,11,37,5.146
2017-09-24 21:00:00+00:00,0,9,9,33,4.904
2017-09-24 22:00:00+00:00,0,13,13,31,4.625
2017-09-24 23:00:00+00:00,0,6,6,30,4.373
2017-09-25 00:00:00+00:00,0,1,1,29,4.142
2017-09-25 01:00:00+00:00,0,1,1,28,3.838
2017-09-25 02:00:00+00:00,0,1,1,29,3.645
2017-09-25 03:00:00+00:00,0,0,0,32,3.434
2017-09-25 04:00:00+00:00,0,1,1,42,3.16
2017-09-25 05:00:00+00:00,26,0,26,50,3.078
2017-09-25 06:00:00+00:00,93,1,94,51,5.099
2017-09-25 07:00:00+00:00,192,6,198,50,9.289
2017-09-25 08:00:00+00:00,288,16,304,48,10.754
2017-09-25 09:00:00+00:00,364,34,398,47,10.609
2017-09-25 10:00:00+00:00,409,62,471,43,11.22
2017-09-25 11:00:00+00:00,432,91,523,41,11.628
2017-09-25 12:00:00+00:00,407,108,515,39,11.559
2017-09-25 13:00:00+00:00,332,102,434,40,10.988
2017-09-25 14:00:00+00:00,240,92,332,41,10.051
2017-09-25 15:00:00+00:00,139,85,224,44,9.053
2017-09-25 16:00:00+00:00,51,98,149,47,7.614
2017-09-25 17:00:00+00:00,5,191,196,50,6.354
2017-09-25 18:00:00+00:00,0,278,278,49,5.828
2017-09-25 19:00:00+00:00,0,302,302,43,5.329
2017-09-25 20:00:00+00:00,0,291,291,37,5.081
2017-09-25 21:00:00+00:00,0,265,265,33,4.899
2017-09-25 22:00:00+00:00,0,272,272,33,4.717
2017-09-25 23:00:00+00:00,0,323,323,32,4.413
2017-09-26 00:00:00+00:00,0,357,357,31,4.057
2017-09-26 01:00:00+00:00,0,341,341,31,3.775
2017-09-26 02:00:00+00:00,0,345,345,31,3.588
2017-09-26 03:00:00+00:00,0,322,322,33,3.271
2017-09-26 04:00:00+00:00,0,328,328,43,2.959
2017-09-26 05:00:00+00:00,26,317,343,52,2.995
2017-09-26 06:00:00+00:00,94,248,342,53,4.821
2017-09-26 07:00:00+00:00,197,190,387,50,6.598
2017-09-26 08:00:00+00:00,295,128,423,46,9.072
2017-09-26 09:00:00+00:00,368,90,458,43,10.881
2017-09-26 10:00:00+00:00,411,71,482,39,11.664
2017-09-26 11:00:00+00:00,427,69,496,36,11.823
2017-09-26 12:00:00+00:00,409,79,488,36,11.676
2017-09-26 13:00:00+00:00,349,75,424,38,11.309
2017-09-26 14:00:00+00:00,248,63,311,40,10.733
2017-09-26 15:00:00+00:00,139,107,246,45,9.819
2017-09-26 16:00:00+00:00,51,168,219,49,8.053
2017-09-26 17:00:00+00:00,5,210,215,52,6.403
2017-09-26 18:00:00+00:00,0,227,227,49,5.707
2017-09-26 19:00:00+00:00,0,229,229,41,5.019
2017-09-26 20:00:00+00:00,0,216,216,36,4.504
2017-09-26 21:00:00+00:00,0,197,197,33,4.261
2017-09-26 22:00:00+00:00,0,165,165,33,4.038
2017-09-26 23:00:00+00:00,0,135,135,32,3.853
2017-09-27 00:00:00+00:00,0,99,99,31,3.717
2017-09-27 01:00:00+00:00,0,102,102,31,3.581
2017-09-27 02:00:00+00:00,0,94,94,31,3.492
2017-09-27 03:00:00+00:00,0,71,71,33,3.38
2017-09-27 04:00:00+00:00,0,85,85,43,3.209
2017-09-27 05:00:00+00:00,28,86,114,51,3.481
2017-09-27 06:00:00+00:00,109,86,195,53,5.688
2017-09-27 07:00:00+00:00,237,66,303,50,7.524
2017-09-27 08:00:00+00:00,363,38,401,44,9.348
2017-09-27 09:00:00+00:00,456,68,524,40,11.083
2017-09-27 10:00:00+00:00,505,94,599,36,12.218
2017-09-27 11:00:00+00:00,510,123,633,34,12.88
2017-09-27 12:00:00+00:00,467,144,611,34,13.102
2017-09-27 13:00:00+00:00,385,156,541,36,12.883
2017-09-27 14:00:00+00:00,268,138,406,38,12.209
2017-09-27 15:00:00+00:00,144,83,227,44,11.572
2017-09-27 16:00:00+00:00,48,78,126,49,9.457
2017-09-27 17:00:00+00:00,4,109,113,52,7.608
2017-09-27 18:00:00+00:00,0,118,118,47,6.72
2017-09-27 19:00:00+00:00,0,189,189,39,5.954
2017-09-27 20:00:00+00:00,0,267,267,35,5.434
2017-09-27 21:00:00+00:00,0,299,299,32,5.267
2017-09-27 22:00:00+00:00,0,323,323,32,5.153
2017-09-27 23:00:00+00:00,0,386,386,31,5.043
2017-09-28 00:00:00+00:00,0,470,470,30,4.863
2017-09-28 01:00:00+00:00,0,553,553,29,4.584
2017-09-28 02:00:00+00:00,0,576,576,30,4.234
2017-09-28 03:00:00+00:00,0,631,631,32,3.914
2017-09-28 04:00:00+00:00,0,644,644,41,3.734
2017-09-28 05:00:00+00:00,25,627,652,50,3.872
2017-09-28 06:00:00+00:00,94,510,604,53,5.63
2017-09-28 07:00:00+00:00,204,319,523,50,7.961
2017-09-28 08:00:00+00:00,326,312,638,46,11.081
2017-09-28 09:00:00+00:00,429,370,799,45,13.123
2017-09-28 10:00:00+00:00,497,477,974,39,14.03
2017-09-28 11:00:00+00:00,513,502,1015,40,14.517
2017-09-28 12:00:00+00:00,477,469,946,39,14.533
2017-09-28 13:00:00+00:00,394,378,772,40,14.153
2017-09-28 14:00:00+00:00,274,329,603,41,13.332
2017-09-28 15:00:00+00:00,147,308,455,46,12.203
2017-09-28 16:00:00+00:00,49,485,534,49,10.117
2017-09-28 17:00:00+00:00,4,684,688,54,8.918
2017-09-28 18:00:00+00:00,0,761,761,49,8.528
2017-09-28 19:00:00+00:00,0,812,812,42,7.965
2017-09-28 20:00:00+00:00,0,817,817,38,7.223
2017-09-28 21:00:00+00:00,0,721,721,34,6.67
2017-09-28 22:00:00+00:00,0,617,617,33,6.389
2017-09-28 23:00:00+00:00,0,454,454,32,6.176
2017-09-29 00:00:00+00:00,0,382,382,31,5.979
2017-09-29 01:00:00+00:00,0,415,415,30,6.043
2017-09-29 02:00:00+00:00,0,507,507,30,6.091
2017-09-29 03:00:00+00:00,0,545,545,33,5.961
2017-09-29 04:00:00+00:00,0,508,508,41,5.645
2017-09-29 05:00:00+00:00,26,437,463,49,5.388
2017-09-29 06:00:00+00:00,97,317,414,53,6.516
2017-09-29 07:00:00+00:00,219,248,467,50,8.805
2017-09-29 08:00:00+00:00,350,290,640,47,10.817
2017-09-29 09:00:00+00:00,455,403,858,44,12.229
2017-09-29 10:00:00+00:00,516,586,1102,38,13.237
2017-09-29 11:00:00+00:00,524,631,1155,37,13.855
2017-09-29 12:00:00+00:00,479,517,996,36,13.965
2017-09-29 13:00:00+00:00,382,454,836,37,13.564
2017-09-29 14:00:00+00:00,262,433,695,39,12.607
2017-09-29 15:00:00+00:00,137,394,531,43,11.46
2017-09-29 16:00:00+00:00,44,552,596,46,9.782
2017-09-29 17:00:00+00:00,3,706,709,47,8.691
2017-09-29 18:00:00+00:00,0,794,794,43,8.257
2017-09-29 19:00:00+00:00,0,966,966,36,7.722
2017-09-29 20:00:00+00:00,0,1183,1183,34,7.092
2017-09-29 21:00:00+00:00,0,1270,1270,31,6.638
2017-09-29 22:00:00+00:00,0,1286,1286,29,6.329
2017-09-29 23:00:00+00:00,0,1265,1265,26,6.027
2017-09-30 00:00:00+00:00,0,1127,1127,27,5.822
2017-09-30 01:00:00+00:00,0,1034,1034,28,5.661
2017-09-30 02:00:00+00:00,0,959,959,29,5.515
2017-09-30 03:00:00+00:00,0,1034,1034,29,5.349
2017-09-30 04:00:00+00:00,0,1078,1078,32,5.066
2017-09-30 05:00:00+00:00,26,1024,1050,35,4.916
2017-09-30 06:00:00+00:00,103,795,898,39,6.263
2017-09-30 07:00:00+00:00,233,593,826,41,8.108
2017-09-30 08:00:00+00:00,376,654,1030,42,10.495
2017-09-30 09:00:00+00:00,493,1060,1553,40,12.444
2017-09-30 10:00:00+00:00,561,1615,2176,36,13.602
2017-09-30 11:00:00+00:00,569,1508,2077,35,14.27
2017-09-30 12:00:00+00:00,519,1336,1855,33,14.438
2017-09-30 13:00:00+00:00,422,1246,1668,34,14.09
2017-09-30 14:00:00+00:00,291,1228,1519,34,13.198
2017-09-30 15:00:00+00:00,153,1112,1265,37,12.213
2017-09-30 16:00:00+00:00,49,1121,1170,42,10.321
2017-09-30 17:00:00+00:00,3,1323,1326,43,8.875
2017-09-30 18:00:00+00:00,0,1430,1430,42,7.939
2017-09-30 19:00:00+00:00,0,1580,1580,35,7.048
2017-09-30 20:00:00+00:00,0,1735,1735,32,6.398
2017-09-30 21:00:00+00:00,0,1715,1715,29,6.067
2017-09-30 22:00:00+00:00,0,1670,1670,29,6.057
2017-09-30 23:00:00+00:00,0,1618,1618,23,5.972
2017-10-01 00:00:00+00:00,0,1688,1688,23,5.904
2017-10-01 01:00:00+00:00,0,1758,1758,23,5.977
2017-10-01 02:00:00+00:00,0,1789,1789,23,5.652
2017-10-01 03:00:00+00:00,0,1806,1806,25,5.709
2017-10-01 04:00:00+00:00,0,1678,1678,27,5.461
2017-10-01 05:00:00+00:00,21,1493,1514,28,5.295
2017-10-01 06:00:00+00:00,79,1133,1212,32,5.809
2017-10-01 07:00:00+00:00,183,714,897,34,6.418
2017-10-01 08:00:00+00:00,305,721,1026,33,7.109
2017-10-01 09:00:00+00:00,402,1113,1515,34,7.833
2017-10-01 10:00:00+00:00,450,1289,1739,31,8.413
2017-10-01 11:00:00+00:00,448,1019,1467,28,8.928
2017-10-01 12:00:00+00:00,402,817,1219,25,9.196
2017-10-01 13:00:00+00:00,316,665,981,24,9.08
2017-10-01 14:00:00+00:00,214,575,789,24,8.605
2017-10-01 15:00:00+00:00,113,438,551,31,7.91
2017-10-01 16:00:00+00:00,37,408,445,38,7.01
2017-10-01 17:00:00+00:00,2,509,511,38,6.194
2017-10-01 18:00:00+00:00,0,581,581,36,5.735
2017-10-01 19:00:00+00:00,0,560,560,29,5.281
2017-10-01 20:00:00+00:00,0,532,532,23,4.837
2017-10-01 21:00:00+00:00,0,519,519,15,4.531
2017-10-01 22:00:00+00:00,0,554,554,5,4.384
2017-10-01 23:00:00+00:00,0,671,671,5,4.197
2017-10-02 00:00:00+00:00,0,788,788,-2,4.086
2017-10-02 01:00:00+00:00,0,788,788,-6,3.888
2017-10-02 02:00:00+00:00,0,789,789,-5,3.687
2017-10-02 03:00:00+00:00,0,814,814,5,3.463
2017-10-02 04:00:00+00:00,0,827,827,25,3.07
2017-10-02 05:00:00+00:00,22,730,752,32,2.817
2017-10-02 06:00:00+00:00,92,647,739,32,4.4
2017-10-02 07:00:00+00:00,227,540,767,31,6.735
2017-10-02 08:00:00+00:00,389,593,982,31,10.566
2017-10-02 09:00:00+00:00,525,859,1384,31,12.136
2017-10-02 10:00:00+00:00,605,1478,2083,27,13.301
2017-10-02 11:00:00+00:00,613,1550,2163,27,14.063
2017-10-02 12:00:00+00:00,550,1457,2007,25,14.143
2017-10-02 13:00:00+00:00,428,1416,1844,26,13.92
2017-10-02 14:00:00+00:00,272,1331,1603,26,13.628
2017-10-02 15:00:00+00:00,129,1145,1274,29,12.067
2017-10-02 16:00:00+00:00,38,1192,1230,33,10.094
2017-10-02 17:00:00+00:00,2,1323,1325,34,8.963
2017-10-02 18:00:00+00:00,0,1500,1500,35,8.34
2017-10-02 19:00:00+00:00,0,1573,1573,29,7.531
2017-10-02 20:00:00+00:00,0,1557,1557,24,6.66
2017-10-02 21:00:00+00:00,0,1383,1383,11,6.346
2017-10-02 22:00:00+00:00,0,1138,1138,15,6.21
2017-10-02 23:00:00+00:00,0,845,845,15,6.179
2017-10-03 00:00:00+00:00,0,624,624,15,6.199
2017-10-03 01:00:00+00:00,0,490,490,15,6.254
2017-10-03 02:00:00+00:00,0,334,334,15,6.193
2017-10-03 03:00:00+00:00,0,292,292,17,5.989
2017-10-03 04:00:00+00:00,0,269,269,22,5.697
2017-10-03 05:00:00+00:00,17,291,308,27,5.629
2017-10-03 06:00:00+00:00,62,386,448,28,6.396
2017-10-03 07:00:00+00:00,137,472,609,27,7.192
2017-10-03 08:00:00+00:00,216,560,776,24,7.947
2017-10-03 09:00:00+00:00,273,672,945,22,8.719
2017-10-03 10:00:00+00:00,304,642,946,15,9.796
2017-10-03 11:00:00+00:00,324,719,1043,12,9.607
2017-10-03 12:00:00+00:00,278,769,1047,8,8.618
2017-10-03 13:00:00+00:00,209,1078,1287,10,7.951
2017-10-03 14:00:00+00:00,161,1772,1933,14,7.502
2017-10-03 15:00:00+00:00,96,2288,2384,25,6.712
2017-10-03 16:00:00+00:00,33,1984,2017,31,5.275
2017-10-03 17:00:00+00:00,2,1657,1659,35,4.093
2017-10-03 18:00:00+00:00,0,1504,1504,36,3.859
2017-10-03 19:00:00+00:00,0,1332,1332,30,3.475
2017-10-03 20:00:00+00:00,0,1302,1302,27,3.358
2017-10-03 21:00:00+00:00,0,1341,1341,19,3.286
2017-10-03 22:00:00+00:00,0,1292,1292,20,3.242
2017-10-03 23:00:00+00:00,0,1296,1296,18,3.069
2017-10-04 00:00:00+00:00,0,1290,1290,17,2.701
2017-10-04 01:00:00+00:00,0,1217,1217,19,2.306
2017-10-04 02:00:00+00:00,0,1214,1214,18,2.188
2017-10-04 03:00:00+00:00,0,996,996,26,1.8
2017-10-04 04:00:00+00:00,0,841,841,36,0.93
2017-10-04 05:00:00+00:00,21,581,602,43,0.059
2017-10-04 06:00:00+00:00,89,300,389,45,2.181
2017-10-04 07:00:00+00:00,212,114,326,43,4.674
2017-10-04 08:00:00+00:00,350,139,489,37,7.181
2017-10-04 09:00:00+00:00,468,183,651,38,8.716
2017-10-04 10:00:00+00:00,526,218,744,31,9.681
2017-10-04 11:00:00+00:00,516,257,773,26,11.262
2017-10-04 12:00:00+00:00,456,379,835,25,12.112
2017-10-04 13:00:00+00:00,358,461,819,27,12.22
2017-10-04 14:00:00+00:00,233,376,609,26,11.726
2017-10-04 15:00:00+00:00,113,417,530,32,10.49
2017-10-04 16:00:00+00:00,34,460,494,35,8.058
2017-10-04 17:00:00+00:00,1,505,506,35,7.006
2017-10-04 18:00:00+00:00,0,437,437,33,6.285
2017-10-04 19:00:00+00:00,0,451,451,27,5.667
2017-10-04 20:00:00+00:00,0,654,654,21,5.248
2017-10-04 21:00:00+00:00,0,732,732,12,4.838
2017-10-04 22:00:00+00:00,0,1067,1067,1,4.461
2017-10-04 23:00:00+00:00,0,944,944,1,4.271
2017-10-05 00:00:00+00:00,0,1076,1076,7,4.299
2017-10-05 01:00:00+00:00,0,1269,1269,8,4.527
2017-10-05 02:00:00+00:00,0,1270,1270,14,4.872
2017-10-05 03:00:00+00:00,0,1246,1246,18,4.96
2017-10-05 04:00:00+00:00,0,946,946,31,4.61
2017-10-05 05:00:00+00:00,18,681,699,41,4.208
2017-10-05 06:00:00+00:00,78,544,622,42,5.909
2017-10-05 07:00:00+00:00,193,514,707,36,9.628
2017-10-05 08:00:00+00:00,337,552,889,28,12.05
2017-10-05 09:00:00+00:00,484,697,1181,25,13.637
2017-10-05 10:00:00+00:00,590,878,1468,17,14.662
2017-10-05 11:00:00+00:00,614,1016,1630,14,15.264
2017-10-05 12:00:00+00:00,558,1205,1763,11,15.393
2017-10-05 13:00:00+00:00,440,1276,1716,13,14.999
2017-10-05 14:00:00+00:00,282,1314,1596,15,13.977
2017-10-05 15:00:00+00:00,129,1571,1700,25,12.011
2017-10-05 16:00:00+00:00,34,1783,1817,29,8.335
2017-10-05 17:00:00+00:00,1,1874,1875,36,6.845
2017-10-05 18:00:00+00:00,0,2279,2279,31,6.301
2017-10-05 19:00:00+00:00,0,2441,2441,25,5.724
2017-10-05 20:00:00+00:00,0,2381,2381,21,5.269
2017-10-05 21:00:00+00:00,0,1974,1974,15,4.708
2017-10-05 22:00:00+00:00,0,1967,1967,7,4.165
2017-10-05 23:00:00+00:00,0,1903,1903,5,3.757
2017-10-06 00:00:00+00:00,0,1997,1997,4,3.303
2017-10-06 01:00:00+00:00,0,2263,2263,5,2.813
2017-10-06 02:00:00+00:00,0,2184,2184,9,2.262
2017-10-06 03:00:00+00:00,0,2128,2128,14,1.933
2017-10-06 04:00:00+00:00,0,2157,2157,31,1.505
2017-10-06 05:00:00+00:00,19,1977,1996,40,1.105
2017-10-06 06:00:00+00:00,84,1671,1755,42,1.311
2017-10-06 07:00:00+00:00,210,1845,2055,38,1.861
2017-10-06 08:00:00+00:00,345,2178,2523,36,2.833
2017-10-06 09:00:00+00:00,447,2042,2489,35,3.887
2017-10-06 10:00:00+00:00,497,1898,2395,31,4.437
2017-10-06 11:00:00+00:00,480,1748,2228,30,4.662
2017-10-06 12:00:00+00:00,413,1972,2385,29,4.588
2017-10-06 13:00:00+00:00,320,2099,2419,30,4.173
2017-10-06 14:00:00+00:00,213,1732,1945,34,3.413
2017-10-06 15:00:00+00:00,106,1408,1514,39,2.443
2017-10-06 16:00:00+00:00,33,1396,1429,45,1.258
2017-10-06 17:00:00+00:00,1,1393,1394,46,0.623
2017-10-06 18:00:00+00:00,0,1487,1487,42,0.517
2017-10-06 19:00:00+00:00,0,1488,1488,39,0.429
2017-10-06 20:00:00+00:00,0,1486,1486,33,0.205
2017-10-06 21:00:00+00:00,0,1540,1540,25,0.071
2017-10-06 22:00:00+00:00,0,1693,1693,21,0.077
2017-10-06 23:00:00+00:00,0,1889,1889,17,0.093
2017-10-07 00:00:00+00:00,0,1926,1926,14,0.069
2017-10-07 01:00:00+00:00,0,1975,1975,14,0.13
2017-10-07 02:00:00+00:00,0,2024,2024,14,0.238
2017-10-07 03:00:00+00:00,0,2036,2036,16,0.317
2017-10-07 04:00:00+00:00,0,1923,1923,19,0.345
2017-10-07 05:00:00+00:00,18,1832,1850,24,0.307
2017-10-07 06:00:00+00:00,80,1577,1657,25,0.817
2017-10-07 07:00:00+00:00,201,1429,1630,26,1.572
2017-10-07 08:00:00+00:00,336,1669,2005,24,2.451
2017-10-07 09:00:00+00:00,446,1627,2073,21,3.415
2017-10-07 10:00:00+00:00,506,1303,1809,14,4.545
2017-10-07 11:00:00+00:00,504,1083,1587,6,5.426
2017-10-07 12:00:00+00:00,445,1101,1546,3,6.119
2017-10-07 13:00:00+00:00,355,1392,1747,3,6.389
2017-10-07 14:00:00+00:00,234,1466,1700,5,6.207
2017-10-07 15:00:00+00:00,112,1491,1603,12,5.355
2017-10-07 16:00:00+00:00,32,1329,1361,16,3.543
2017-10-07 17:00:00+00:00,1,988,989,17,2.779
2017-10-07 18:00:00+00:00,0,664,664,15,2.175
2017-10-07 19:00:00+00:00,0,376,376,7,1.74
2017-10-07 20:00:00+00:00,0,262,262,3,1.593
2017-10-07 21:00:00+00:00,0,328,328,-5,1.506
2017-10-07 22:00:00+00:00,0,540,540,-6,1.309
2017-10-07 23:00:00+00:00,0,636,636,-6,1.248
2017-10-08 00:00:00+00:00,0,528,528,-6,1.244
2017-10-08 01:00:00+00:00,0,582,582,-4,1.408
2017-10-08 02:00:00+00:00,0,429,429,0,1.159
2017-10-08 03:00:00+00:00,0,647,647,4,0.876
2017-10-08 04:00:00+00:00,0,1032,1032,13,0.476
2017-10-08 05:00:00+00:00,14,1214,1228,21,0.273
2017-10-08 06:00:00+00:00,58,1350,1408,31,1.373
2017-10-08 07:00:00+00:00,141,1531,1672,34,2.772
2017-10-08 08:00:00+00:00,236,1437,1673,34,4.059
2017-10-08 09:00:00+00:00,325,1753,2078,35,5.113
2017-10-08 10:00:00+00:00,406,1722,2128,35,5.819
2017-10-08 11:00:00+00:00,435,1637,2072,30,6.214
2017-10-08 12:00:00+00:00,402,1507,1909,28,6.361
2017-10-08 13:00:00+00:00,321,1455,1776,28,6.311
2017-10-08 14:00:00+00:00,211,1520,1731,33,6.011
2017-10-08 15:00:00+00:00,106,1388,1494,38,5.283
2017-10-08 16:00:00+00:00,32,1512,1544,48,3.101
2017-10-08 17:00:00+00:00,1,1658,1659,52,1.52
2017-10-08 18:00:00+00:00,0,1563,1563,49,1.277
2017-10-08 19:00:00+00:00,0,1472,1472,43,1.243
2017-10-08 20:00:00+00:00,0,1304,1304,41,1.257
2017-10-08 21:00:00+00:00,0,1125,1125,35,1.14
2017-10-08 22:00:00+00:00,0,998,998,28,1.147
2017-10-08 23:00:00+00:00,0,1106,1106,27,1.091
2017-10-09 00:00:00+00:00,0,1109,1109,26,1.103
2017-10-09 01:00:00+00:00,0,1000,1000,26,1.105
2017-10-09 02:00:00+00:00,0,891,891,27,1.091
2017-10-09 03:00:00+00:00,0,878,878,31,1.009
2017-10-09 04:00:00+00:00,0,730,730,44,0.821
2017-10-09 05:00:00+00:00,15,654,669,55,0.781
2017-10-09 06:00:00+00:00,63,479,542,58,2.124
2017-10-09 07:00:00+00:00,157,328,485,57,3.251
2017-10-09 08:00:00+00:00,256,330,586,51,4.239
2017-10-09 09:00:00+00:00,341,383,724,49,5.335
2017-10-09 10:00:00+00:00,368,490,858,46,6.287
2017-10-09 11:00:00+00:00,387,594,981,43,6.972
2017-10-09 12:00:00+00:00,353,454,807,42,7.336
2017-10-09 13:00:00+00:00,274,425,699,43,7.23
2017-10-09 14:00:00+00:00,181,390,571,45,6.607
2017-10-09 15:00:00+00:00,88,278,366,49,5.682
2017-10-09 16:00:00+00:00,26,176,202,58,4.465
2017-10-09 17:00:00+00:00,1,131,132,63,3.671
2017-10-09 18:00:00+00:00,0,156,156,57,3.265
2017-10-09 19:00:00+00:00,0,246,246,43,2.876
2017-10-09 20:00:00+00:00,0,309,309,37,2.493
2017-10-09 21:00:00+00:00,0,356,356,33,2.15
2017-10-09 22:00:00+00:00,0,402,402,34,1.723
2017-10-09 23:00:00+00:00,0,413,413,32,1.244
2017-10-10 00:00:00+00:00,0,548,548,30,0.917
2017-10-10 01:00:00+00:00,0,615,615,31,0.739
2017-10-10 02:00:00+00:00,0,553,553,31,0.637
2017-10-10 03:00:00+00:00,0,605,605,33,0.339
2017-10-10 04:00:00+00:00,0,712,712,43,0.182
2017-10-10 05:00:00+00:00,15,694,709,52,0.138
2017-10-10 06:00:00+00:00,61,525,586,56,1.709
2017-10-10 07:00:00+00:00,159,420,579,53,3.59
2017-10-10 08:00:00+00:00,268,471,739,46,5.309
2017-10-10 09:00:00+00:00,356,462,818,43,6.879
2017-10-10 10:00:00+00:00,401,377,778,37,8.573
2017-10-10 11:00:00+00:00,383,285,668,35,9.514
2017-10-10 12:00:00+00:00,341,497,838,34,9.775
2017-10-10 13:00:00+00:00,274,608,882,34,9.655
2017-10-10 14:00:00+00:00,181,549,730,35,9.052
2017-10-10 15:00:00+00:00,87,542,629,37,7.85
2017-10-10 16:00:00+00:00,25,555,580,40,5.874
2017-10-10 17:00:00+00:00,0,506,506,41,5.192
2017-10-10 18:00:00+00:00,0,605,605,37,4.869
2017-10-10 19:00:00+00:00,0,604,604,33,4.255
2017-10-10 20:00:00+00:00,0,783,783,28,3.772
2017-10-10 21:00:00+00:00,0,764,764,23,3.414
2017-10-10 22:00:00+00:00,0,585,585,23,3.215
2017-10-10 23:00:00+00:00,0,518,518,21,3.067
2017-10-11 00:00:00+00:00,0,582,582,20,2.823
2017-10-11 01:00:00+00:00,0,545,545,20,2.391
2017-10-11 02:00:00+00:00,0,569,569,21,2.025
2017-10-11 03:00:00+00:00,0,566,566,26,1.719
2017-10-11 04:00:00+00:00,0,494,494,36,1.469
2017-10-11 05:00:00+00:00,14,484,498,44,1.285
2017-10-11 06:00:00+00:00,65,486,551,47,2.414
2017-10-11 07:00:00+00:00,176,409,585,43,4.96
2017-10-11 08:00:00+00:00,311,286,597,39,6.96
2017-10-11 09:00:00+00:00,417,288,705,36,9.422
2017-10-11 10:00:00+00:00,474,252,726,33,11.146
2017-10-11 11:00:00+00:00,492,221,713,30,12.033
2017-10-11 12:00:00+00:00,458,223,681,30,12.469
2017-10-11 13:00:00+00:00,365,187,552,31,12.492
2017-10-11 14:00:00+00:00,234,206,440,34,11.863
2017-10-11 15:00:00+00:00,104,151,255,37,10.576
2017-10-11 16:00:00+00:00,27,166,193,41,8.74
2017-10-11 17:00:00+00:00,0,276,276,44,7.854
2017-10-11 18:00:00+00:00,0,301,301,37,7.01
2017-10-11 19:00:00+00:00,0,219,219,32,6.397
2017-10-11 20:00:00+00:00,0,184,184,30,5.972
2017-10-11 21:00:00+00:00,0,136,136,23,5.592
2017-10-11 22:00:00+00:00,0,106,106,19,5.27
2017-10-11 23:00:00+00:00,0,131,131,15,5.063
2017-10-12 00:00:00+00:00,0,150,150,13,4.839
2017-10-12 01:00:00+00:00,0,145,145,11,4.412
2017-10-12 02:00:00+00:00,0,208,208,12,3.893
2017-10-12 03:00:00+00:00,0,251,251,18,3.538
2017-10-12 04:00:00+00:00,0,241,241,30,3.381
2017-10-12 05:00:00+00:00,15,236,251,36,3.429
2017-10-12 06:00:00+00:00,74,304,378,36,4.72
2017-10-12 07:00:00+00:00,195,276,471,32,7.837
2017-10-12 08:00:00+00:00,334,349,683,28,10.272
2017-10-12 09:00:00+00:00,435,376,811,24,11.735
2017-10-12 10:00:00+00:00,492,357,849,17,12.687
2017-10-12 11:00:00+00:00,517,283,800,15,13.225
2017-10-12 12:00:00+00:00,485,430,915,16,13.358
2017-10-12 13:00:00+00:00,381,1002,1383,20,13.069
2017-10-12 14:00:00+00:00,236,1303,1539,25,12.292
2017-10-12 15:00:00+00:00,100,1504,1604,34,10.614
2017-10-12 16:00:00+00:00,25,1532,1557,39,8.11
2017-10-12 17:00:00+00:00,0,1561,1561,43,7.165
2017-10-12 18:00:00+00:00,0,1542,1542,42,6.584
2017-10-12 19:00:00+00:00,0,1318,1318,39,5.982
2017-10-12 20:00:00+00:00,0,1299,1299,36,5.521
2017-10-12 21:00:00+00:00,0,1418,1418,32,5.058
2017-10-12 22:00:00+00:00,0,1279,1279,28,4.789
2017-10-12 23:00:00+00:00,0,1192,1192,27,4.602
2017-10-13 00:00:00+00:00,0,1120,1120,27,4.388
2017-10-13 01:00:00+00:00,0,1139,1139,27,4.27
2017-10-13 02:00:00+00:00,0,1261,1261,28,4.363
2017-10-13 03:00:00+00:00,0,1218,1218,32,4.289
2017-10-13 04:00:00+00:00,0,1153,1153,43,4.093
2017-10-13 05:00:00+00:00,14,1141,1155,54,4.054
2017-10-13 06:00:00+00:00,68,1080,1148,57,4.952
2017-10-13 07:00:00+00:00,184,890,1074,54,7.066
2017-10-13 08:00:00+00:00,322,1074,1396,47,8.437
2017-10-13 09:00:00+00:00,441,1407,1848,44,9.974
2017-10-13 10:00:00+00:00,512,1596,2108,40,11.47
2017-10-13 11:00:00+00:00,522,1522,2044,39,12.392
2017-10-13 12:00:00+00:00,467,1503,1970,36,12.683
2017-10-13 13:00:00+00:00,359,1320,1679,39,12.62
2017-10-13 14:00:00+00:00,226,841,1067,40,12.145
2017-10-13 15:00:00+00:00,98,558,656,46,10.716
2017-10-13 16:00:00+00:00,25,548,573,51,8.615
2017-10-13 17:00:00+00:00,0,566,566,52,7.7
2017-10-13 18:00:00+00:00,0,726,726,45,6.729
2017-10-13 19:00:00+00:00,0,810,810,41,5.828
2017-10-13 20:00:00+00:00,0,1094,1094,36,5.137
2017-10-13 21:00:00+00:00,0,1420,1420,31,4.716
2017-10-13 22:00:00+00:00,0,1283,1283,27,4.436
2017-10-13 23:00:00+00:00,0,1027,1027,26,4.2
2017-10-14 00:00:00+00:00,0,863,863,26,4.099
2017-10-14 01:00:00+00:00,0,692,692,26,4.187
2017-10-14 02:00:00+00:00,0,641,641,26,4.324
2017-10-14 03:00:00+00:00,0,645,645,27,4.326
2017-10-14 04:00:00+00:00,0,687,687,30,4.154
2017-10-14 05:00:00+00:00,14,714,728,33,4.054
2017-10-14 06:00:00+00:00,69,631,700,37,5.014
2017-10-14 07:00:00+00:00,190,391,581,35,7.901
2017-10-14 08:00:00+00:00,341,305,646,30,10.16
2017-10-14 09:00:00+00:00,467,281,748,27,12.993
2017-10-14 10:00:00+00:00,541,367,908,23,14.403
2017-10-14 11:00:00+00:00,548,343,891,16,15.174
2017-10-14 12:00:00+00:00,490,235,725,20,15.476
2017-10-14 13:00:00+00:00,376,195,571,25,15.283
2017-10-14 14:00:00+00:00,231,163,394,32,15.281
2017-10-14 15:00:00+00:00,96,103,199,39,13.642
2017-10-14 16:00:00+00:00,24,67,91,44,11.766
2017-10-14 17:00:00+00:00,0,69,69,47,10.846
2017-10-14 18:00:00+00:00,0,93,93,43,10.095
2017-10-14 19:00:00+00:00,0,102,102,38,9.461
2017-10-14 20:00:00+00:00,0,82,82,37,8.955
2017-10-14 21:00:00+00:00,0,96,96,34,8.581
2017-10-14 22:00:00+00:00,0,121,121,26,8.353
2017-10-14 23:00:00+00:00,0,106,106,24,8.194
2017-10-15 00:00:00+00:00,0,79,79,25,8.054
2017-10-15 01:00:00+00:00,0,62,62,25,7.88
2017-10-15 02:00:00+00:00,0,50,50,26,7.694
2017-10-15 03:00:00+00:00,0,46,46,28,7.24
2017-10-15 04:00:00+00:00,0,41,41,27,6.56
2017-10-15 05:00:00+00:00,13,30,43,30,6.03
2017-10-15 06:00:00+00:00,67,14,81,32,6.668
2017-10-15 07:00:00+00:00,189,3,192,32,9.384
2017-10-15 08:00:00+00:00,340,1,341,30,11.86
2017-10-15 09:00:00+00:00,467,1,468,25,13.979
2017-10-15 10:00:00+00:00,540,1,541,23,16.063
2017-10-15 11:00:00+00:00,546,3,549,17,17.187
2017-10-15 12:00:00+00:00,486,5,491,14,18.397
2017-10-15 13:00:00+00:00,372,7,379,16,18.382
2017-10-15 14:00:00+00:00,226,7,233,26,17.273
2017-10-15 15:00:00+00:00,92,12,104,33,14.836
2017-10-15 16:00:00+00:00,22,32,54,41,12.738
2017-10-15 17:00:00+00:00,0,61,61,45,11.476
2017-10-15 18:00:00+00:00,0,86,86,39,10.512
2017-10-15 19:00:00+00:00,0,150,150,35,9.67
2017-10-15 20:00:00+00:00,0,211,211,32,8.93
2017-10-15 21:00:00+00:00,0,225,225,26,8.34
2017-10-15 22:00:00+00:00,0,280,280,28,7.932
2017-10-15 23:00:00+00:00,0,319,319,26,7.774
2017-10-16 00:00:00+00:00,0,239,239,25,7.814
2017-10-16 01:00:00+00:00,0,139,139,24,7.92
2017-10-16 02:00:00+00:00,0,103,103,27,7.971
2017-10-16 03:00:00+00:00,0,105,105,30,7.953
2017-10-16 04:00:00+00:00,0,77,77,42,7.813
2017-10-16 05:00:00+00:00,12,79,91,55,7.634
2017-10-16 06:00:00+00:00,60,111,171,55,8.278
2017-10-16 07:00:00+00:00,169,92,261,48,10.425
2017-10-16 08:00:00+00:00,312,50,362,42,13.246
2017-10-16 09:00:00+00:00,443,36,479,38,16.529
2017-10-16 10:00:00+00:00,524,28,552,33,18.074
2017-10-16 11:00:00+00:00,539,31,570,32,18.456
2017-10-16 12:00:00+00:00,483,26,509,31,19.087
2017-10-16 13:00:00+00:00,368,34,402,35,19.459
2017-10-16 14:00:00+00:00,222,51,273,40,18.611
2017-10-16 15:00:00+00:00,89,69,158,50,15.143
2017-10-16 16:00:00+00:00,21,102,123,59,13.031
2017-10-16 17:00:00+00:00,0,143,143,62,12.446
2017-10-16 18:00:00+00:00,0,147,147,52,11.715
2017-10-16 19:00:00+00:00,0,111,111,43,10.938
2017-10-16 20:00:00+00:00,0,70,70,38,10.206
2017-10-16 21:00:00+00:00,0,49,49,32,9.55
2017-10-16 22:00:00+00:00,0,20,20,28,9.008
2017-10-16 23:00:00+00:00,0,15,15,27,8.502
2017-10-17 00:00:00+00:00,0,21,21,27,8.031
2017-10-17 01:00:00+00:00,0,28,28,26,7.62
2017-10-17 02:00:00+00:00,0,45,45,26,7.245
2017-10-17 03:00:00+00:00,0,41,41,29,6.694
2017-10-17 04:00:00+00:00,0,46,46,41,6.024
2017-10-17 05:00:00+00:00,12,35,47,52,5.522
2017-10-17 06:00:00+00:00,61,23,84,50,6.21
2017-10-17 07:00:00+00:00,175,12,187,42,8.95
2017-10-17 08:00:00+00:00,322,9,331,36,11.364
2017-10-17 09:00:00+00:00,448,9,457,34,13.669
2017-10-17 10:00:00+00:00,527,29,556,30,15.7
2017-10-17 11:00:00+00:00,536,59,595,30,16.319
2017-10-17 12:00:00+00:00,478,89,567,30,16.374
2017-10-17 13:00:00+00:00,362,134,496,35,17.113
2017-10-17 14:00:00+00:00,218,159,377,38,16.117
2017-10-17 15:00:00+00:00,87,238,325,49,13.25
2017-10-17 16:00:00+00:00,21,405,426,58,11.107
2017-10-17 17:00:00+00:00,0,571,571,60,9.613
2017-10-17 18:00:00+00:00,0,790,790,49,8.306
2017-10-17 19:00:00+00:00,0,939,939,43,7.223
2017-10-17 20:00:00+00:00,0,1011,1011,40,6.384
2017-10-17 21:00:00+00:00,0,1104,1104,36,5.886
2017-10-17 22:00:00+00:00,0,1093,1093,34,5.529
2017-10-17 23:00:00+00:00,0,1101,1101,33,5.324
2017-10-18 00:00:00+00:00,0,1161,1161,33,5.096
2017-10-18 01:00:00+00:00,0,1096,1096,33,4.713
2017-10-18 02:00:00+00:00,0,1015,1015,32,4.309
2017-10-18 03:00:00+00:00,0,996,996,36,3.945
2017-10-18 04:00:00+00:00,0,899,899,49,3.777
2017-10-18 05:00:00+00:00,12,700,712,67,3.74
2017-10-18 06:00:00+00:00,58,536,594,71,4.497
2017-10-18 07:00:00+00:00,159,401,560,64,7.317
2017-10-18 08:00:00+00:00,287,246,533,54,9.565
2017-10-18 09:00:00+00:00,389,203,592,49,12.021
2017-10-18 10:00:00+00:00,464,221,685,43,13.586
2017-10-18 11:00:00+00:00,492,220,712,42,14.118
2017-10-18 12:00:00+00:00,444,207,651,43,14.23
2017-10-18 13:00:00+00:00,339,173,512,44,13.895
2017-10-18 14:00:00+00:00,208,105,313,50,13.201
2017-10-18 15:00:00+00:00,84,66,150,60,11.343
2017-10-18 16:00:00+00:00,20,75,95,73,9.273
2017-10-18 17:00:00+00:00,0,84,84,80,8.627
2017-10-18 18:00:00+00:00,0,81,81,61,7.995
2017-10-18 19:00:00+00:00,0,73,73,47,7.335
2017-10-18 20:00:00+00:00,0,114,114,41,6.77
2017-10-18 21:00:00+00:00,0,133,133,36,6.284
2017-10-18 22:00:00+00:00,0,164,164,36,5.764
2017-10-18 23:00:00+00:00,0,210,210,35,5.246
2017-10-19 00:00:00+00:00,0,221,221,33,4.854
2017-10-19 01:00:00+00:00,0,258,258,33,4.651
2017-10-19 02:00:00+00:00,0,266,266,33,4.634
2017-10-19 03:00:00+00:00,0,259,259,36,4.605
2017-10-19 04:00:00+00:00,0,272,272,49,4.51
2017-10-19 05:00:00+00:00,12,216,228,64,4.401
2017-10-19 06:00:00+00:00,58,181,239,70,4.91
2017-10-19 07:00:00+00:00,169,113,282,64,7.214
2017-10-19 08:00:00+00:00,315,100,415,54,9.372
2017-10-19 09:00:00+00:00,441,77,518,48,11.917
2017-10-19 10:00:00+00:00,515,76,591,41,13.3
2017-10-19 11:00:00+00:00,522,54,576,42,13.944
2017-10-19 12:00:00+00:00,460,31,491,41,14.064
2017-10-19 13:00:00+00:00,346,12,358,45,13.781
2017-10-19 14:00:00+00:00,206,8,214,48,13.704
2017-10-19 15:00:00+00:00,81,11,92,54,11.178
2017-10-19 16:00:00+00:00,19,25,44,63,8.697
2017-10-19 17:00:00+00:00,0,31,31,62,7.54
2017-10-19 18:00:00+00:00,0,19,19,43,6.374
2017-10-19 19:00:00+00:00,0,20,20,37,5.337
2017-10-19 20:00:00+00:00,0,20,20,32,4.478
2017-10-19 21:00:00+00:00,0,20,20,29,3.913
2017-10-19 22:00:00+00:00,0,17,17,29,3.541
2017-10-19 23:00:00+00:00,0,19,19,29,3.29
2017-10-20 00:00:00+00:00,0,22,22,28,3.128
2017-10-20 01:00:00+00:00,0,34,34,28,3.002
2017-10-20 02:00:00+00:00,0,36,36,28,2.933
2017-10-20 03:00:00+00:00,0,44,44,31,2.832
2017-10-20 04:00:00+00:00,0,63,63,39,2.916
2017-10-20 05:00:00+00:00,11,74,85,50,3.271
2017-10-20 06:00:00+00:00,53,53,106,55,4.302
2017-10-20 07:00:00+00:00,151,27,178,47,6.74
2017-10-20 08:00:00+00:00,277,14,291,44,9.668
2017-10-20 09:00:00+00:00,405,8,413,41,11.646
2017-10-20 10:00:00+00:00,485,8,493,36,13.09
2017-10-20 11:00:00+00:00,484,4,488,33,13.61
2017-10-20 12:00:00+00:00,418,7,425,33,13.607
2017-10-20 13:00:00+00:00,311,15,326,35,13.131
2017-10-20 14:00:00+00:00,186,26,212,36,12.264
2017-10-20 15:00:00+00:00,73,38,111,45,10.642
2017-10-20 16:00:00+00:00,18,51,69,51,9.296
2017-10-20 17:00:00+00:00,0,44,44,49,8.607
2017-10-20 18:00:00+00:00,0,46,46,39,7.743
2017-10-20 19:00:00+00:00,0,61,61,35,7.118
2017-10-20 20:00:00+00:00,0,73,73,34,6.855
2017-10-20 21:00:00+00:00,0,72,72,31,6.936
2017-10-20 22:00:00+00:00,0,69,69,64,7.09
2017-10-20 23:00:00+00:00,0,51,51,61,7.34
2017-10-21 00:00:00+00:00,0,47,47,61,7.53
2017-10-21 01:00:00+00:00,0,44,44,59,7.489
2017-10-21 02:00:00+00:00,0,57,57,61,7.249
2017-10-21 03:00:00+00:00,0,53,53,60,6.914
2017-10-21 04:00:00+00:00,0,52,52,63,6.503
2017-10-21 05:00:00+00:00,9,45,54,72,6.061
2017-10-21 06:00:00+00:00,40,49,89,83,6.079
2017-10-21 07:00:00+00:00,113,41,154,86,7.899
2017-10-21 08:00:00+00:00,205,34,239,80,10.026
2017-10-21 09:00:00+00:00,284,35,319,77,11.592
2017-10-21 10:00:00+00:00,332,64,396,71,12.058
2017-10-21 11:00:00+00:00,339,137,476,67,12.249
2017-10-21 12:00:00+00:00,311,122,433,63,12.161
2017-10-21 13:00:00+00:00,248,140,388,64,11.789
2017-10-21 14:00:00+00:00,156,190,346,68,11.275
2017-10-21 15:00:00+00:00,64,169,233,80,10.428
2017-10-21 16:00:00+00:00,17,165,182,88,9.374
2017-10-21 17:00:00+00:00,0,124,124,90,8.419
2017-10-21 18:00:00+00:00,0,99,99,76,7.629
2017-10-21 19:00:00+00:00,0,54,54,66,6.915
2017-10-21 20:00:00+00:00,0,31,31,60,6.273
2017-10-21 21:00:00+00:00,0,40,40,44,5.808
2017-10-21 22:00:00+00:00,0,29,29,29,5.494
2017-10-21 23:00:00+00:00,0,59,59,18,5.309
2017-10-22 00:00:00+00:00,0,99,99,10,5.254
2017-10-22 01:00:00+00:00,0,81,81,8,5.09
2017-10-22 02:00:00+00:00,0,67,67,8,4.809
2017-10-22 03:00:00+00:00,0,122,122,8,4.069
2017-10-22 04:00:00+00:00,0,335,335,12,3.39
2017-10-22 05:00:00+00:00,9,575,584,21,2.793
2017-10-22 06:00:00+00:00,37,993,1030,25,2.387
2017-10-22 07:00:00+00:00,100,1610,1710,30,2.429
2017-10-22 08:00:00+00:00,157,1988,2145,33,2.905
2017-10-22 09:00:00+00:00,212,1901,2113,32,3.597
2017-10-22 10:00:00+00:00,235,1746,1981,27,4.127
2017-10-22 11:00:00+00:00,212,1563,1775,23,4.281
2017-10-22 12:00:00+00:00,198,1131,1329,29,4.267
2017-10-22 13:00:00+00:00,165,750,915,33,3.969
2017-10-22 14:00:00+00:00,106,571,677,43,3.121
2017-10-22 15:00:00+00:00,46,458,504,65,2.017
2017-10-22 16:00:00+00:00,14,544,558,79,1.227
2017-10-22 17:00:00+00:00,0,662,662,85,0.546
2017-10-22 18:00:00+00:00,0,806,806,78,0.122
2017-10-22 19:00:00+00:00,0,1111,1111,70,0.041
2017-10-22 20:00:00+00:00,0,1383,1383,67,0.163
2017-10-22 21:00:00+00:00,0,1532,1532,53,0.174
2017-10-22 22:00:00+00:00,0,1675,1675,54,0.013
2017-10-22 23:00:00+00:00,0,1868,1868,49,-0.146
2017-10-23 00:00:00+00:00,0,1861,1861,49,-0.301
2017-10-23 01:00:00+00:00,0,1969,1969,48,-0.408
2017-10-23 02:00:00+00:00,0,2125,2125,50,-0.528
2017-10-23 03:00:00+00:00,0,2307,2307,59,-0.655
2017-10-23 04:00:00+00:00,0,2298,2298,83,-0.789
2017-10-23 05:00:00+00:00,9,2248,2257,102,-0.948
2017-10-23 06:00:00+00:00,35,2270,2305,104,-0.889
2017-10-23 07:00:00+00:00,98,2305,2403,98,-0.493
2017-10-23 08:00:00+00:00,174,2289,2463,93,-0.053
2017-10-23 09:00:00+00:00,230,2229,2459,93,0.491
2017-10-23 10:00:00+00:00,256,2300,2556,88,1.044
2017-10-23 11:00:00+00:00,264,2346,2610,82,1.575
2017-10-23 12:00:00+00:00,244,2409,2653,84,1.984
2017-10-23 13:00:00+00:00,196,2438,2634,88,2.057
2017-10-23 14:00:00+00:00,126,2460,2586,92,1.723
2017-10-23 15:00:00+00:00,53,2501,2554,105,0.998
2017-10-23 16:00:00+00:00,15,2509,2524,120,0.339
2017-10-23 17:00:00+00:00,0,2458,2458,120,0.044
2017-10-23 18:00:00+00:00,0,2437,2437,98,-0.149
2017-10-23 19:00:00+00:00,0,2404,2404,88,-0.213
2017-10-23 20:00:00+00:00,0,2346,2346,76,-0.213
2017-10-23 21:00:00+00:00,0,2398,2398,67,-0.128
2017-10-23 22:00:00+00:00,0,2373,2373,37,-0.025
2017-10-23 23:00:00+00:00,0,2373,2373,36,0.094
2017-10-24 00:00:00+00:00,0,2374,2374,35,0.235
2017-10-24 01:00:00+00:00,0,2439,2439,34,0.382
2017-10-24 02:00:00+00:00,0,2410,2410,34,0.526
2017-10-24 03:00:00+00:00,0,2341,2341,36,0.679
2017-10-24 04:00:00+00:00,0,2239,2239,47,0.793
2017-10-24 05:00:00+00:00,9,2264,2273,57,0.871
2017-10-24 06:00:00+00:00,44,2136,2180,59,1.088
2017-10-24 07:00:00+00:00,134,1978,2112,54,1.604
2017-10-24 08:00:00+00:00,255,1943,2198,53,2.076
2017-10-24 09:00:00+00:00,359,1857,2216,51,2.629
2017-10-24 10:00:00+00:00,409,1821,2230,45,3.207
2017-10-24 11:00:00+00:00,405,1861,2266,42,3.777
2017-10-24 12:00:00+00:00,355,1744,2099,40,4.114
2017-10-24 13:00:00+00:00,261,1563,1824,41,4.248
2017-10-24 14:00:00+00:00,156,1328,1484,41,3.99
2017-10-24 15:00:00+00:00,63,1241,1304,46,2.909
2017-10-24 16:00:00+00:00,16,1214,1230,48,1.135
2017-10-24 17:00:00+00:00,0,1220,1220,45,0.604
2017-10-24 18:00:00+00:00,0,1044,1044,38,0.589
2017-10-24 19:00:00+00:00,0,913,913,35,0.403
2017-10-24 20:00:00+00:00,0,777,777,31,0.309
2017-10-24 21:00:00+00:00,0,627,627,24,0.482
2017-10-24 22:00:00+00:00,0,583,583,19,1.036
2017-10-24 23:00:00+00:00,0,544,544,16,1.542
2017-10-25 00:00:00+00:00,0,450,450,15,1.589
2017-10-25 01:00:00+00:00,0,304,304,15,1.597
2017-10-25 02:00:00+00:00,0,214,214,18,1.516
2017-10-25 03:00:00+00:00,0,203,203,25,1.459
2017-10-25 04:00:00+00:00,0,225,225,35,1.272
2017-10-25 05:00:00+00:00,9,195,204,42,0.956
2017-10-25 06:00:00+00:00,37,178,215,42,1.458
2017-10-25 07:00:00+00:00,108,223,331,40,4.102
2017-10-25 08:00:00+00:00,195,237,432,38,6.255
2017-10-25 09:00:00+00:00,282,197,479,35,9.449
2017-10-25 10:00:00+00:00,332,185,517,31,11.192
2017-10-25 11:00:00+00:00,336,173,509,30,11.413
2017-10-25 12:00:00+00:00,304,208,512,30,11.296
2017-10-25 13:00:00+00:00,232,298,530,32,10.972
2017-10-25 14:00:00+00:00,139,412,551,34,10.427
2017-10-25 15:00:00+00:00,54,517,571,40,8.811
2017-10-25 16:00:00+00:00,14,585,599,47,7.669
2017-10-25 17:00:00+00:00,0,495,495,47,7.225
2017-10-25 18:00:00+00:00,0,448,448,42,6.712
2017-10-25 19:00:00+00:00,0,374,374,38,6.533
2017-10-25 20:00:00+00:00,0,401,401,37,6.603
2017-10-25 21:00:00+00:00,0,432,432,32,6.537
2017-10-25 22:00:00+00:00,0,468,468,30,6.27
2017-10-25 23:00:00+00:00,0,483,483,30,5.699
2017-10-26 00:00:00+00:00,0,616,616,29,5.063
2017-10-26 01:00:00+00:00,0,667,667,30,4.848
2017-10-26 02:00:00+00:00,0,648,648,30,4.698
2017-10-26 03:00:00+00:00,0,627,627,32,4.362
2017-10-26 04:00:00+00:00,0,555,555,43,3.912
2017-10-26 05:00:00+00:00,11,467,478,52,3.615
2017-10-26 06:00:00+00:00,52,357,409,51,3.928
2017-10-26 07:00:00+00:00,150,285,435,47,6.22
2017-10-26 08:00:00+00:00,263,206,469,45,9.182
2017-10-26 09:00:00+00:00,347,91,438,42,10.266
2017-10-26 10:00:00+00:00,386,67,453,38,11.884
2017-10-26 11:00:00+00:00,387,81,468,36,13.379
2017-10-26 12:00:00+00:00,338,96,434,35,13.878
2017-10-26 13:00:00+00:00,237,75,312,37,13.818
2017-10-26 14:00:00+00:00,132,79,211,40,12.957
2017-10-26 15:00:00+00:00,50,130,180,45,10.676
2017-10-26 16:00:00+00:00,13,196,209,50,9.244
2017-10-26 17:00:00+00:00,0,224,224,50,8.473
2017-10-26 18:00:00+00:00,0,282,282,45,7.54
2017-10-26 19:00:00+00:00,0,420,420,39,6.58
2017-10-26 20:00:00+00:00,0,676,676,35,6.019
2017-10-26 21:00:00+00:00,0,743,743,30,5.61
2017-10-26 22:00:00+00:00,0,843,843,25,5.43
2017-10-26 23:00:00+00:00,0,889,889,22,5.253
2017-10-27 00:00:00+00:00,0,790,790,18,5.193
2017-10-27 01:00:00+00:00,0,672,672,18,5.043
2017-10-27 02:00:00+00:00,0,639,639,19,5.041
2017-10-27 03:00:00+00:00,0,508,508,23,4.799
2017-10-27 04:00:00+00:00,0,327,327,32,4.478
2017-10-27 05:00:00+00:00,9,315,324,38,3.281
2017-10-27 06:00:00+00:00,40,312,352,40,3.907
2017-10-27 07:00:00+00:00,110,484,594,38,5.736
2017-10-27 08:00:00+00:00,186,733,919,36,6.666
2017-10-27 09:00:00+00:00,227,1296,1523,34,6.657
2017-10-27 10:00:00+00:00,216,2166,2382,29,6.456
2017-10-27 11:00:00+00:00,219,1971,2190,25,5.588
2017-10-27 12:00:00+00:00,207,1814,2021,24,4.3
2017-10-27 13:00:00+00:00,166,2111,2277,25,3.44
2017-10-27 14:00:00+00:00,113,2476,2589,33,2.7
2017-10-27 15:00:00+00:00,48,2458,2506,39,1.763
2017-10-27 16:00:00+00:00,13,2429,2442,45,1.035
2017-10-27 17:00:00+00:00,0,2419,2419,46,0.766
2017-10-27 18:00:00+00:00,0,2585,2585,40,0.642
2017-10-27 19:00:00+00:00,0,2638,2638,36,0.52
2017-10-27 20:00:00+00:00,0,2662,2662,33,0.355
2017-10-27 21:00:00+00:00,0,2614,2614,28,0.322
2017-10-27 22:00:00+00:00,0,2465,2465,20,0.328
2017-10-27 23:00:00+00:00,0,2326,2326,16,0.309
2017-10-28 00:00:00+00:00,0,2427,2427,9,0.19
2017-10-28 01:00:00+00:00,0,2336,2336,5,0.086
2017-10-28 02:00:00+00:00,0,2004,2004,2,-0.012
2017-10-28 03:00:00+00:00,0,1926,1926,1,-0.159
2017-10-28 04:00:00+00:00,0,1904,1904,5,-0.362
2017-10-28 05:00:00+00:00,9,1897,1906,6,-0.441
2017-10-28 06:00:00+00:00,34,1700,1734,20,-0.298
2017-10-28 07:00:00+00:00,98,1624,1722,20,0.424
2017-10-28 08:00:00+00:00,175,1668,1843,14,1.154
2017-10-28 09:00:00+00:00,244,1797,2041,10,1.758
2017-10-28 10:00:00+00:00,287,1975,2262,0,2.225
2017-10-28 11:00:00+00:00,300,2387,2687,-3,2.766
2017-10-28 12:00:00+00:00,271,2408,2679,-7,3.375
2017-10-28 13:00:00+00:00,198,2366,2564,-7,3.273
2017-10-28 14:00:00+00:00,112,2142,2254,-1,2.729
2017-10-28 15:00:00+00:00,42,2159,2201,5,1.641
2017-10-28 16:00:00+00:00,12,2351,2363,16,0.084
2017-10-28 17:00:00+00:00,0,2488,2488,15,-0.816
2017-10-28 18:00:00+00:00,0,2465,2465,-4,-0.993
2017-10-28 19:00:00+00:00,0,2304,2304,-12,-1.384
2017-10-28 20:00:00+00:00,0,2334,2334,-29,-1.692
2017-10-28 21:00:00+00:00,0,2548,2548,-43,-1.554
2017-10-28 22:00:00+00:00,0,2421,2421,-37,-1.123
2017-10-28 23:00:00+00:00,0,2399,2399,-40,-0.761
2017-10-29 00:00:00+00:00,0,2432,2432,-52,-0.408
2017-10-29 01:00:00+00:00,0,2366,2366,-51,0.204
2017-10-29 02:00:00+00:00,0,2298,2298,-76,1.015
2017-10-29 03:00:00+00:00,0,2141,2141,-76,1.842
2017-10-29 04:00:00+00:00,0,1845,1845,-48,2.478
2017-10-29 05:00:00+00:00,0,1869,1869,-48,2.928
2017-10-29 06:00:00+00:00,32,1772,1804,-61,3.365
2017-10-29 07:00:00+00:00,98,1973,2071,-28,4.176
2017-10-29 08:00:00+00:00,183,2208,2391,-23,4.869
2017-10-29 09:00:00+00:00,263,2175,2438,-22,5.205
2017-10-29 10:00:00+00:00,270,2474,2744,-7,5.071
2017-10-29 11:00:00+00:00,264,2458,2722,-7,4.466
2017-10-29 12:00:00+00:00,291,2125,2416,-9,3.777
2017-10-29 13:00:00+00:00,249,1879,2128,-6,3.065
2017-10-29 14:00:00+00:00,145,2011,2156,0,2.089
2017-10-29 15:00:00+00:00,52,2270,2322,16,0.794
2017-10-29 16:00:00+00:00,16,2426,2442,27,-0.291
2017-10-29 17:00:00+00:00,12,2441,2453,33,-0.835
2017-10-29 18:00:00+00:00,0,2512,2512,27,-1.134
2017-10-29 19:00:00+00:00,0,2487,2487,26,-1.189
2017-10-29 20:00:00+00:00,0,2479,2479,24,-1.235
2017-10-29 21:00:00+00:00,0,2475,2475,24,-1.399
2017-10-29 22:00:00+00:00,0,2407,2407,19,-1.621
2017-10-29 23:00:00+00:00,0,2406,2406,11,-1.811
2017-10-30 00:00:00+00:00,0,2428,2428,9,-2.002
2017-10-30 01:00:00+00:00,0,2297,2297,10,-2.241
2017-10-30 02:00:00+00:00,0,2339,2339,11,-2.486
2017-10-30 03:00:00+00:00,0,2401,2401,12,-2.809
2017-10-30 04:00:00+00:00,0,2430,2430,18,-3.003
2017-10-30 05:00:00+00:00,0,2452,2452,31,-3.081
2017-10-30 06:00:00+00:00,31,2409,2440,40,-2.983
2017-10-30 07:00:00+00:00,95,2400,2495,38,-1.985
2017-10-30 08:00:00+00:00,182,2460,2642,37,-0.895
2017-10-30 09:00:00+00:00,264,2495,2759,36,-0.044
2017-10-30 10:00:00+00:00,275,2493,2768,36,0.475
2017-10-30 11:00:00+00:00,272,2492,2764,34,0.805
2017-10-30 12:00:00+00:00,301,2402,2703,33,0.896
2017-10-30 13:00:00+00:00,260,2223,2483,35,0.659
2017-10-30 14:00:00+00:00,156,2067,2223,40,0.046
2017-10-30 15:00:00+00:00,59,2084,2143,43,-1.172
2017-10-30 16:00:00+00:00,18,2185,2203,54,-2.847
2017-10-30 17:00:00+00:00,13,2186,2199,61,-3.213
2017-10-30 18:00:00+00:00,0,2184,2184,58,-3.339
2017-10-30 19:00:00+00:00,0,2264,2264,48,-3.579
2017-10-30 20:00:00+00:00,0,2167,2167,44,-3.63
2017-10-30 21:00:00+00:00,0,2127,2127,40,-3.686
2017-10-30 22:00:00+00:00,0,2028,2028,35,-3.821
2017-10-30 23:00:00+00:00,0,1742,1742,35,-3.976
2017-10-31 00:00:00+00:00,0,1668,1668,33,-4.034
2017-10-31 01:00:00+00:00,0,1486,1486,30,-4.257
2017-10-31 02:00:00+00:00,0,1311,1311,30,-4.375
2017-10-31 03:00:00+00:00,0,1242,1242,32,-4.366
2017-10-31 04:00:00+00:00,0,1042,1042,32,-4.284
2017-10-31 05:00:00+00:00,0,911,911,36,-4.224
2017-10-31 06:00:00+00:00,34,995,1029,41,-3.654
2017-10-31 07:00:00+00:00,113,970,1083,42,-1.174
2017-10-31 08:00:00+00:00,224,799,1023,40,0.946
2017-10-31 09:00:00+00:00,320,755,1075,39,2.587
2017-10-31 10:00:00+00:00,374,854,1228,39,3.698
2017-10-31 11:00:00+00:00,377,960,1337,37,4.43
2017-10-31 12:00:00+00:00,325,819,1144,35,4.704
2017-10-31 13:00:00+00:00,237,772,1009,36,4.447
2017-10-31 14:00:00+00:00,132,669,801,37,3.613
2017-10-31 15:00:00+00:00,45,558,603,39,1.658
2017-10-31 16:00:00+00:00,12,532,544,47,0.273
2017-10-31 17:00:00+00:00,8,509,517,49,-0.189
2017-10-31 18:00:00+00:00,0,615,615,45,-0.705
2017-10-31 19:00:00+00:00,0,724,724,41,-1.134
2017-10-31 20:00:00+00:00,0,752,752,36,-1.37
2017-10-31 21:00:00+00:00,0,664,664,33,-1.606
2017-10-31 22:00:00+00:00,0,722,722,28,-1.727
2017-10-31 23:00:00+00:00,0,683,683,25,-1.968
2017-11-01 00:00:00+00:00,0,571,571,23,-2.273
2017-11-01 01:00:00+00:00,0,499,499,23,-2.493
2017-11-01 02:00:00+00:00,0,479,479,21,-2.572
2017-11-01 03:00:00+00:00,0,437,437,22,-2.471
2017-11-01 04:00:00+00:00,0,395,395,24,-2.269
2017-11-01 05:00:00+00:00,0,363,363,31,-2.014
2017-11-01 06:00:00+00:00,31,312,343,35,-1.372
2017-11-01 07:00:00+00:00,98,290,388,34,0.989
2017-11-01 08:00:00+00:00,183,213,396,34,3.02
2017-11-01 09:00:00+00:00,261,152,413,33,4.557
2017-11-01 10:00:00+00:00,307,165,472,32,5.518
2017-11-01 11:00:00+00:00,308,178,486,31,5.953
2017-11-01 12:00:00+00:00,268,241,509,29,6.015
2017-11-01 13:00:00+00:00,198,486,684,30,5.766
2017-11-01 14:00:00+00:00,111,696,807,32,4.916
2017-11-01 15:00:00+00:00,37,761,798,35,3.422
2017-11-01 16:00:00+00:00,10,604,614,41,2.694
2017-11-01 17:00:00+00:00,8,581,589,44,2.315
2017-11-01 18:00:00+00:00,0,584,584,42,1.859
2017-11-01 19:00:00+00:00,0,540,540,32,1.325
2017-11-01 20:00:00+00:00,0,460,460,29,0.84
2017-11-01 21:00:00+00:00,0,378,378,28,0.508
2017-11-01 22:00:00+00:00,0,388,388,20,0.317
2017-11-01 23:00:00+00:00,0,320,320,22,0.063
2017-11-02 00:00:00+00:00,0,269,269,20,-0.169
2017-11-02 01:00:00+00:00,0,211,211,19,-0.286
2017-11-02 02:00:00+00:00,0,151,151,18,-0.2
2017-11-02 03:00:00+00:00,0,192,192,20,-0.36
2017-11-02 04:00:00+00:00,0,191,191,26,-0.575
2017-11-02 05:00:00+00:00,0,250,250,36,-0.534
2017-11-02 06:00:00+00:00,30,272,302,43,0.15
2017-11-02 07:00:00+00:00,94,307,401,44,2.012
2017-11-02 08:00:00+00:00,182,257,439,40,3.571
2017-11-02 09:00:00+00:00,261,195,456,38,4.465
2017-11-02 10:00:00+00:00,313,178,491,38,5.377
2017-11-02 11:00:00+00:00,331,254,585,37,6.182
2017-11-02 12:00:00+00:00,300,287,587,36,6.413
2017-11-02 13:00:00+00:00,227,423,650,37,6.363
2017-11-02 14:00:00+00:00,131,652,783,43,5.53
2017-11-02 15:00:00+00:00,45,803,848,48,3.689
2017-11-02 16:00:00+00:00,11,1055,1066,56,2.344
2017-11-02 17:00:00+00:00,8,1501,1509,59,2.255
2017-11-02 18:00:00+00:00,0,1229,1229,56,2.22
2017-11-02 19:00:00+00:00,0,1172,1172,49,2.198
2017-11-02 20:00:00+00:00,0,1219,1219,44,2.119
2017-11-02 21:00:00+00:00,0,1301,1301,41,1.998
2017-11-02 22:00:00+00:00,0,1105,1105,38,1.918
2017-11-02 23:00:00+00:00,0,927,927,36,1.875
2017-11-03 00:00:00+00:00,0,776,776,35,1.846
2017-11-03 01:00:00+00:00,0,811,811,35,1.816
2017-11-03 02:00:00+00:00,0,819,819,33,1.764
2017-11-03 03:00:00+00:00,0,809,809,35,1.771
2017-11-03 04:00:00+00:00,0,843,843,38,1.796
2017-11-03 05:00:00+00:00,0,678,678,52,1.818
2017-11-03 06:00:00+00:00,31,741,772,66,1.876
2017-11-03 07:00:00+00:00,103,721,824,67,2.807
2017-11-03 08:00:00+00:00,201,617,818,65,3.612
2017-11-03 09:00:00+00:00,279,552,831,64,3.998
2017-11-03 10:00:00+00:00,330,516,846,60,4.613
2017-11-03 11:00:00+00:00,361,468,829,56,5.716
2017-11-03 12:00:00+00:00,336,377,713,52,6.5
2017-11-03 13:00:00+00:00,258,248,506,52,6.384
2017-11-03 14:00:00+00:00,147,184,331,54,5.865
2017-11-03 15:00:00+00:00,49,134,183,59,4.342
2017-11-03 16:00:00+00:00,12,108,120,66,2.602
2017-11-03 17:00:00+00:00,8,99,107,68,1.241
2017-11-03 18:00:00+00:00,0,58,58,65,0.194
2017-11-03 19:00:00+00:00,0,50,50,51,-0.318
2017-11-03 20:00:00+00:00,0,106,106,42,-0.095
2017-11-03 21:00:00+00:00,0,135,135,38,0.544
2017-11-03 22:00:00+00:00,0,190,190,34,0.781
2017-11-03 23:00:00+00:00,0,431,431,35,0.651
2017-11-04 00:00:00+00:00,0,757,757,35,0.413
2017-11-04 01:00:00+00:00,0,1183,1183,33,0.376
2017-11-04 02:00:00+00:00,0,1406,1406,32,0.301
2017-11-04 03:00:00+00:00,0,1523,1523,32,0.083
2017-11-04 04:00:00+00:00,0,1723,1723,33,-0.024
2017-11-04 05:00:00+00:00,0,1837,1837,34,-0.265
2017-11-04 06:00:00+00:00,32,1824,1856,38,-0.416
2017-11-04 07:00:00+00:00,97,1618,1715,42,1.544
2017-11-04 08:00:00+00:00,191,1596,1787,43,2.876
2017-11-04 09:00:00+00:00,299,1718,2017,41,4.524
2017-11-04 10:00:00+00:00,377,1842,2219,38,6.193
2017-11-04 11:00:00+00:00,390,2013,2403,35,7.396
2017-11-04 12:00:00+00:00,342,1978,2320,33,7.761
2017-11-04 13:00:00+00:00,244,1841,2085,34,7.567
2017-11-04 14:00:00+00:00,131,1580,1711,34,6.431
2017-11-04 15:00:00+00:00,42,1557,1599,36,4.342
2017-11-04 16:00:00+00:00,10,1705,1715,39,3.058
2017-11-04 17:00:00+00:00,8,1851,1859,39,2.481
2017-11-04 18:00:00+00:00,0,1772,1772,36,2.073
2017-11-04 19:00:00+00:00,0,1696,1696,29,1.831
2017-11-04 20:00:00+00:00,0,1576,1576,26,1.88
2017-11-04 21:00:00+00:00,0,1526,1526,24,1.684
2017-11-04 22:00:00+00:00,0,1556,1556,17,1.578
2017-11-04 23:00:00+00:00,0,1530,1530,16,1.781
2017-11-05 00:00:00+00:00,0,1441,1441,14,1.796
2017-11-05 01:00:00+00:00,0,1415,1415,15,1.708
2017-11-05 02:00:00+00:00,0,1384,1384,15,1.812
2017-11-05 03:00:00+00:00,0,1270,1270,19,2.065
2017-11-05 04:00:00+00:00,0,1203,1203,23,2.479
2017-11-05 05:00:00+00:00,0,1181,1181,30,2.984
2017-11-05 06:00:00+00:00,30,1253,1283,33,3.397
2017-11-05 07:00:00+00:00,97,1308,1405,35,4.281
2017-11-05 08:00:00+00:00,189,1270,1459,37,5.253
2017-11-05 09:00:00+00:00,271,1249,1520,37,6.063
2017-11-05 10:00:00+00:00,333,1230,1563,40,6.471
2017-11-05 11:00:00+00:00,346,1182,1528,40,6.461
2017-11-05 12:00:00+00:00,299,1264,1563,37,6.338
2017-11-05 13:00:00+00:00,207,1406,1613,35,6.021
2017-11-05 14:00:00+00:00,109,1711,1820,36,5.299
2017-11-05 15:00:00+00:00,35,2054,2089,38,4.667
2017-11-05 16:00:00+00:00,10,2183,2193,46,3.988
2017-11-05 17:00:00+00:00,8,1925,1933,50,3.012
2017-11-05 18:00:00+00:00,0,1727,1727,49,2.205
2017-11-05 19:00:00+00:00,0,1084,1084,44,1.035
2017-11-05 20:00:00+00:00,0,595,595,39,0.346
2017-11-05 21:00:00+00:00,0,309,309,38,-0.027
2017-11-05 22:00:00+00:00,0,316,316,34,-0.265
2017-11-05 23:00:00+00:00,0,441,441,34,-0.579
2017-11-06 00:00:00+00:00,0,456,456,31,-0.771
2017-11-06 01:00:00+00:00,0,321,321,31,-1.081
2017-11-06 02:00:00+00:00,0,273,273,31,-1.443
2017-11-06 03:00:00+00:00,0,225,225,33,-1.76
2017-11-06 04:00:00+00:00,0,151,151,36,-2.246
2017-11-06 05:00:00+00:00,0,179,179,49,-2.733
2017-11-06 06:00:00+00:00,19,236,255,63,-3.155
2017-11-06 07:00:00+00:00,60,222,282,67,-2.73
2017-11-06 08:00:00+00:00,112,211,323,63,-2.106
2017-11-06 09:00:00+00:00,156,215,371,61,-1.662
2017-11-06 10:00:00+00:00,185,235,420,59,-1.244
2017-11-06 11:00:00+00:00,188,287,475,56,-0.957
2017-11-06 12:00:00+00:00,164,329,493,55,-0.851
2017-11-06 13:00:00+00:00,123,308,431,53,-0.908
2017-11-06 14:00:00+00:00,71,340,411,59,-1.106
2017-11-06 15:00:00+00:00,24,518,542,69,-1.431
2017-11-06 16:00:00+00:00,9,613,622,82,-1.855
2017-11-06 17:00:00+00:00,8,619,627,97,-2.165
2017-11-06 18:00:00+00:00,0,579,579,78,-2.405
2017-11-06 19:00:00+00:00,0,642,642,65,-2.532
2017-11-06 20:00:00+00:00,0,613,613,53,-2.615
2017-11-06 21:00:00+00:00,0,500,500,47,-2.742
2017-11-06 22:00:00+00:00,0,438,438,39,-2.814
2017-11-06 23:00:00+00:00,0,454,454,38,-2.868
2017-11-07 00:00:00+00:00,0,438,438,38,-3.03
2017-11-07 01:00:00+00:00,0,418,418,36,-3.229
2017-11-07 02:00:00+00:00,0,432,432,36,-3.322
2017-11-07 03:00:00+00:00,0,477,477,36,-3.373
2017-11-07 04:00:00+00:00,0,440,440,38,-3.322
2017-11-07 05:00:00+00:00,0,453,453,51,-3.423
2017-11-07 06:00:00+00:00,22,369,391,63,-3.382
2017-11-07 07:00:00+00:00,73,283,356,64,-2.32
2017-11-07 08:00:00+00:00,147,169,316,61,-0.63
2017-11-07 09:00:00+00:00,205,101,306,58,-0.087
2017-11-07 10:00:00+00:00,235,91,326,56,0.225
2017-11-07 11:00:00+00:00,241,108,349,54,0.28
2017-11-07 12:00:00+00:00,218,127,345,54,0.309
2017-11-07 13:00:00+00:00,166,172,338,55,0.398
2017-11-07 14:00:00+00:00,90,226,316,58,0.337
2017-11-07 15:00:00+00:00,28,268,296,61,-0.33
2017-11-07 16:00:00+00:00,9,429,438,72,-1.333
2017-11-07 17:00:00+00:00,8,472,480,71,-2.103
2017-11-07 18:00:00+00:00,0,505,505,62,-2.878
2017-11-07 19:00:00+00:00,0,519,519,51,-3.702
2017-11-07 20:00:00+00:00,0,535,535,45,-4.123
2017-11-07 21:00:00+00:00,0,414,414,38,-4.669
2017-11-07 22:00:00+00:00,0,335,335,34,-5.179
2017-11-07 23:00:00+00:00,0,363,363,36,-5.194
2017-11-08 00:00:00+00:00,0,435,435,36,-4.999
2017-11-08 01:00:00+00:00,0,463,463,35,-4.743
2017-11-08 02:00:00+00:00,0,462,462,35,-4.775
2017-11-08 03:00:00+00:00,0,445,445,36,-5.176
2017-11-08 04:00:00+00:00,0,421,421,36,-5.346
2017-11-08 05:00:00+00:00,0,398,398,50,-5.246
2017-11-08 06:00:00+00:00,19,384,403,67,-4.742
2017-11-08 07:00:00+00:00,66,422,488,76,-3.431
2017-11-08 08:00:00+00:00,129,436,565,72,-1.269
2017-11-08 09:00:00+00:00,170,342,512,71,0.994
2017-11-08 10:00:00+00:00,195,294,489,73,2.06
2017-11-08 11:00:00+00:00,202,277,479,71,2.599
2017-11-08 12:00:00+00:00,177,226,403,70,2.623
2017-11-08 13:00:00+00:00,129,225,354,70,2.225
2017-11-08 14:00:00+00:00,70,204,274,80,1.551
2017-11-08 15:00:00+00:00,23,194,217,88,0.809
2017-11-08 16:00:00+00:00,9,129,138,110,0.426
2017-11-08 17:00:00+00:00,8,56,64,116,0.297
2017-11-08 18:00:00+00:00,0,21,21,90,0.022
2017-11-08 19:00:00+00:00,0,11,11,67,-0.569
2017-11-08 20:00:00+00:00,0,6,6,53,-1.06
2017-11-08 21:00:00+00:00,0,5,5,49,-1.366
2017-11-08 22:00:00+00:00,0,4,4,41,-1.591
2017-11-08 23:00:00+00:00,0,4,4,39,-1.754
2017-11-09 00:00:00+00:00,0,6,6,38,-1.853
2017-11-09 01:00:00+00:00,0,8,8,38,-1.837
2017-11-09 02:00:00+00:00,0,12,12,37,-1.792
2017-11-09 03:00:00+00:00,0,12,12,39,-1.751
2017-11-09 04:00:00+00:00,0,20,20,41,-1.822
2017-11-09 05:00:00+00:00,0,13,13,54,-1.957
2017-11-09 06:00:00+00:00,24,9,33,73,-2.004
2017-11-09 07:00:00+00:00,83,10,93,73,-1.358
2017-11-09 08:00:00+00:00,170,8,178,66,0.497
2017-11-09 09:00:00+00:00,246,7,253,63,2.054
2017-11-09 10:00:00+00:00,286,17,303,60,2.465
2017-11-09 11:00:00+00:00,282,27,309,54,2.358
2017-11-09 12:00:00+00:00,250,27,277,53,2.393
2017-11-09 13:00:00+00:00,184,16,200,53,2.267
2017-11-09 14:00:00+00:00,98,24,122,56,1.87
2017-11-09 15:00:00+00:00,30,24,54,56,1.079
2017-11-09 16:00:00+00:00,9,44,53,64,0.429
2017-11-09 17:00:00+00:00,8,71,79,67,-0.123
2017-11-09 18:00:00+00:00,0,134,134,56,-0.554
2017-11-09 19:00:00+00:00,0,187,187,46,-1.058
2017-11-09 20:00:00+00:00,0,217,217,37,-1.535
2017-11-09 21:00:00+00:00,0,263,263,35,-1.9
2017-11-09 22:00:00+00:00,0,368,368,31,-2.153
2017-11-09 23:00:00+00:00,0,449,449,29,-2.323
2017-11-10 00:00:00+00:00,0,510,510,28,-2.706
2017-11-10 01:00:00+00:00,0,539,539,27,-3.32
2017-11-10 02:00:00+00:00,0,484,484,26,-3.955
2017-11-10 03:00:00+00:00,0,496,496,27,-4.515
2017-11-10 04:00:00+00:00,0,515,515,30,-4.996
2017-11-10 05:00:00+00:00,0,468,468,35,-5.464
2017-11-10 06:00:00+00:00,25,586,611,42,-5.847
2017-11-10 07:00:00+00:00,95,758,853,46,-4.662
2017-11-10 08:00:00+00:00,201,613,814,42,-2.137
2017-11-10 09:00:00+00:00,298,524,822,39,-0.09
2017-11-10 10:00:00+00:00,359,415,774,38,1.239
2017-11-10 11:00:00+00:00,367,305,672,35,1.559
2017-11-10 12:00:00+00:00,313,363,676,32,1.53
2017-11-10 13:00:00+00:00,217,444,661,31,1.373
2017-11-10 14:00:00+00:00,109,506,615,32,1.048
2017-11-10 15:00:00+00:00,32,441,473,33,0.68
2017-11-10 16:00:00+00:00,9,416,425,37,0.184
2017-11-10 17:00:00+00:00,8,450,458,37,-0.544
2017-11-10 18:00:00+00:00,0,446,446,35,-1.183
2017-11-10 19:00:00+00:00,0,525,525,31,-1.886
2017-11-10 20:00:00+00:00,0,689,689,26,-2.541
2017-11-10 21:00:00+00:00,0,846,846,24,-2.986
2017-11-10 22:00:00+00:00,0,1002,1002,18,-3.148
2017-11-10 23:00:00+00:00,0,963,963,6,-3.188
2017-11-11 00:00:00+00:00,0,1280,1280,4,-3.291
2017-11-11 01:00:00+00:00,0,1344,1344,-1,-3.283
2017-11-11 02:00:00+00:00,0,1100,1100,0,-3.388
2017-11-11 03:00:00+00:00,0,1120,1120,5,-3.677
2017-11-11 04:00:00+00:00,0,1379,1379,7,-4.064
2017-11-11 05:00:00+00:00,0,1469,1469,9,-4.396
2017-11-11 06:00:00+00:00,21,1287,1308,17,-4.478
2017-11-11 07:00:00+00:00,73,907,980,23,-3.605
2017-11-11 08:00:00+00:00,145,936,1081,27,-1.765
2017-11-11 09:00:00+00:00,210,1343,1553,27,-0.795
2017-11-11 10:00:00+00:00,251,1476,1727,28,-0.111
2017-11-11 11:00:00+00:00,259,1565,1824,28,0.402
2017-11-11 12:00:00+00:00,226,1477,1703,28,0.623
2017-11-11 13:00:00+00:00,161,1200,1361,28,0.566
2017-11-11 14:00:00+00:00,84,691,775,31,0.198
2017-11-11 15:00:00+00:00,26,472,498,37,-0.479
2017-11-11 16:00:00+00:00,9,447,456,42,-1.17
2017-11-11 17:00:00+00:00,8,678,686,43,-1.565
2017-11-11 18:00:00+00:00,0,929,929,42,-1.883
2017-11-11 19:00:00+00:00,0,1101,1101,38,-2.133
2017-11-11 20:00:00+00:00,0,1206,1206,35,-2.333
2017-11-11 21:00:00+00:00,0,1134,1134,35,-2.321
2017-11-11 22:00:00+00:00,0,1093,1093,31,-2.023
2017-11-11 23:00:00+00:00,0,966,966,28,-1.662
2017-11-12 00:00:00+00:00,0,736,736,24,-1.157
2017-11-12 01:00:00+00:00,0,621,621,24,-0.767
2017-11-12 02:00:00+00:00,0,564,564,21,-0.665
2017-11-12 03:00:00+00:00,0,502,502,20,-0.673
2017-11-12 04:00:00+00:00,0,373,373,20,-0.531
2017-11-12 05:00:00+00:00,0,212,212,21,-0.259
2017-11-12 06:00:00+00:00,16,214,230,23,-0.15
2017-11-12 07:00:00+00:00,56,217,273,31,0.211
2017-11-12 08:00:00+00:00,117,78,195,34,1.282
2017-11-12 09:00:00+00:00,169,34,203,37,2.066
2017-11-12 10:00:00+00:00,201,96,297,40,2.208
2017-11-12 11:00:00+00:00,201,120,321,38,1.967
2017-11-12 12:00:00+00:00,169,204,373,37,1.789
2017-11-12 13:00:00+00:00,125,418,543,36,1.678
2017-11-12 14:00:00+00:00,70,686,756,36,1.462
2017-11-12 15:00:00+00:00,23,968,991,37,1.076
2017-11-12 16:00:00+00:00,8,1217,1225,44,0.805
2017-11-12 17:00:00+00:00,8,1091,1099,46,0.58
2017-11-12 18:00:00+00:00,0,1001,1001,44,0.481
2017-11-12 19:00:00+00:00,0,910,910,38,0.22
2017-11-12 20:00:00+00:00,0,1182,1182,35,-0.285
2017-11-12 21:00:00+00:00,0,1602,1602,36,-1.64
2017-11-12 22:00:00+00:00,0,1593,1593,32,-2.995
2017-11-12 23:00:00+00:00,0,2098,2098,26,-4.095
2017-11-13 00:00:00+00:00,0,2540,2540,25,-4.547
2017-11-13 01:00:00+00:00,0,2527,2527,24,-4.779
2017-11-13 02:00:00+00:00,0,2507,2507,21,-4.794
2017-11-13 03:00:00+00:00,0,2390,2390,23,-4.667
2017-11-13 04:00:00+00:00,0,2275,2275,29,-4.603
2017-11-13 05:00:00+00:00,0,2351,2351,43,-4.631
2017-11-13 06:00:00+00:00,15,2360,2375,56,-4.659
2017-11-13 07:00:00+00:00,48,2397,2445,54,-4.602
2017-11-13 08:00:00+00:00,102,2438,2540,49,-4.519
2017-11-13 09:00:00+00:00,149,2402,2551,48,-4.316
2017-11-13 10:00:00+00:00,173,2398,2571,48,-4.033
2017-11-13 11:00:00+00:00,179,2415,2594,47,-3.942
2017-11-13 12:00:00+00:00,160,2291,2451,46,-4.002
2017-11-13 13:00:00+00:00,119,2244,2363,46,-4.008
2017-11-13 14:00:00+00:00,64,2245,2309,49,-4.162
2017-11-13 15:00:00+00:00,21,2310,2331,60,-4.435
2017-11-13 16:00:00+00:00,8,2440,2448,69,-4.602
2017-11-13 17:00:00+00:00,8,2397,2405,69,-4.643
2017-11-13 18:00:00+00:00,0,2328,2328,62,-4.686
2017-11-13 19:00:00+00:00,0,2152,2152,51,-4.746
2017-11-13 20:00:00+00:00,0,2184,2184,45,-4.814
2017-11-13 21:00:00+00:00,0,2112,2112,40,-4.848
2017-11-13 22:00:00+00:00,0,2110,2110,36,-4.852
2017-11-13 23:00:00+00:00,0,2235,2235,36,-4.876
2017-11-14 00:00:00+00:00,0,2005,2005,36,-5.128
2017-11-14 01:00:00+00:00,0,1943,1943,35,-5.625
2017-11-14 02:00:00+00:00,0,2054,2054,34,-6.221
2017-11-14 03:00:00+00:00,0,2110,2110,34,-6.668
2017-11-14 04:00:00+00:00,0,2092,2092,35,-6.85
2017-11-14 05:00:00+00:00,0,2095,2095,47,-6.97
2017-11-14 06:00:00+00:00,20,1849,1869,59,-7.229
2017-11-14 07:00:00+00:00,76,1616,1692,54,-6.569
2017-11-14 08:00:00+00:00,160,1498,1658,41,-4.937
2017-11-14 09:00:00+00:00,240,1653,1893,42,-3.987
2017-11-14 10:00:00+00:00,291,1825,2116,41,-3.261
2017-11-14 11:00:00+00:00,297,1842,2139,38,-2.757
2017-11-14 12:00:00+00:00,258,1597,1855,40,-2.501
2017-11-14 13:00:00+00:00,184,1301,1485,42,-2.6
2017-11-14 14:00:00+00:00,92,942,1034,44,-3.305
2017-11-14 15:00:00+00:00,27,660,687,51,-5.279
2017-11-14 16:00:00+00:00,8,434,442,57,-7.477
2017-11-14 17:00:00+00:00,8,382,390,55,-8.604
2017-11-14 18:00:00+00:00,0,515,515,54,-9.622
2017-11-14 19:00:00+00:00,0,768,768,52,-10.303
2017-11-14 20:00:00+00:00,0,965,965,46,-10.672
2017-11-14 21:00:00+00:00,0,1003,1003,40,-10.782
2017-11-14 22:00:00+00:00,0,942,942,36,-10.602
2017-11-14 23:00:00+00:00,0,907,907,34,-10.36
2017-11-15 00:00:00+00:00,0,867,867,34,-10.206
2017-11-15 01:00:00+00:00,0,827,827,33,-10.085
2017-11-15 02:00:00+00:00,0,811,811,33,-9.884
2017-11-15 03:00:00+00:00,0,698,698,35,-9.651
2017-11-15 04:00:00+00:00,0,568,568,38,-9.401
2017-11-15 05:00:00+00:00,0,470,470,53,-9.087
2017-11-15 06:00:00+00:00,15,442,457,71,-8.766
2017-11-15 07:00:00+00:00,65,320,385,74,-7.407
2017-11-15 08:00:00+00:00,147,233,380,70,-4.733
2017-11-15 09:00:00+00:00,226,167,393,67,-2.513
2017-11-15 10:00:00+00:00,279,135,414,67,-1.55
2017-11-15 11:00:00+00:00,295,124,419,66,-0.668
2017-11-15 12:00:00+00:00,266,101,367,67,-0.101
2017-11-15 13:00:00+00:00,193,47,240,71,-0.162
2017-11-15 14:00:00+00:00,97,25,122,76,-0.747
2017-11-15 15:00:00+00:00,28,69,97,87,-2.463
2017-11-15 16:00:00+00:00,8,78,86,111,-4.019
2017-11-15 17:00:00+00:00,8,48,56,128,-4.892
2017-11-15 18:00:00+00:00,0,32,32,105,-5.298
2017-11-15 19:00:00+00:00,0,32,32,69,-5.415
2017-11-15 20:00:00+00:00,0,44,44,56,-5.346
2017-11-15 21:00:00+00:00,0,76,76,49,-5.095
2017-11-15 22:00:00+00:00,0,76,76,41,-4.874
2017-11-15 23:00:00+00:00,0,60,60,38,-4.727
2017-11-16 00:00:00+00:00,0,61,61,38,-4.488
2017-11-16 01:00:00+00:00,0,59,59,37,-4.175
2017-11-16 02:00:00+00:00,0,62,62,37,-3.834
2017-11-16 03:00:00+00:00,0,87,87,36,-3.551
2017-11-16 04:00:00+00:00,0,104,104,39,-3.443
2017-11-16 05:00:00+00:00,0,97,97,57,-3.466
2017-11-16 06:00:00+00:00,17,82,99,74,-3.517
2017-11-16 07:00:00+00:00,71,72,143,69,-2.338
2017-11-16 08:00:00+00:00,159,60,219,57,-0.147
2017-11-16 09:00:00+00:00,247,48,295,54,1.043
2017-11-16 10:00:00+00:00,309,37,346,53,1.655
2017-11-16 11:00:00+00:00,322,33,355,52,2.061
2017-11-16 12:00:00+00:00,279,52,331,52,2.215
2017-11-16 13:00:00+00:00,196,94,290,51,2.082
2017-11-16 14:00:00+00:00,97,122,219,52,1.625
2017-11-16 15:00:00+00:00,27,145,172,57,0.931
2017-11-16 16:00:00+00:00,8,198,206,65,0.177
2017-11-16 17:00:00+00:00,8,217,225,61,-0.503
2017-11-16 18:00:00+00:00,0,231,231,56,-0.962
2017-11-16 19:00:00+00:00,0,254,254,48,-1.357
2017-11-16 20:00:00+00:00,0,226,226,39,-1.812
2017-11-16 21:00:00+00:00,0,186,186,36,-2.254
2017-11-16 22:00:00+00:00,0,159,159,34,-2.634
2017-11-16 23:00:00+00:00,0,149,149,32,-3.183
2017-11-17 00:00:00+00:00,0,219,219,31,-3.848
2017-11-17 01:00:00+00:00,0,409,409,30,-4.305
2017-11-17 02:00:00+00:00,0,621,621,31,-4.453
2017-11-17 03:00:00+00:00,0,820,820,32,-4.641
2017-11-17 04:00:00+00:00,0,808,808,34,-4.983
2017-11-17 05:00:00+00:00,0,775,775,45,-5.358
2017-11-17 06:00:00+00:00,17,911,928,58,-5.55
2017-11-17 07:00:00+00:00,68,870,938,58,-4.603
2017-11-17 08:00:00+00:00,150,792,942,52,-2.72
2017-11-17 09:00:00+00:00,222,868,1090,51,-1.248
2017-11-17 10:00:00+00:00,269,781,1050,50,-0.165
2017-11-17 11:00:00+00:00,275,868,1143,46,0.477
2017-11-17 12:00:00+00:00,238,839,1077,46,0.653
2017-11-17 13:00:00+00:00,165,785,950,46,0.451
2017-11-17 14:00:00+00:00,79,755,834,49,-0.159
2017-11-17 15:00:00+00:00,22,794,816,51,-1.668
2017-11-17 16:00:00+00:00,8,858,866,56,-3.2
2017-11-17 17:00:00+00:00,8,811,819,51,-3.804
2017-11-17 18:00:00+00:00,0,913,913,43,-4.265
2017-11-17 19:00:00+00:00,0,1074,1074,36,-4.659
2017-11-17 20:00:00+00:00,0,1100,1100,33,-4.906
2017-11-17 21:00:00+00:00,0,1088,1088,31,-4.887
2017-11-17 22:00:00+00:00,0,1049,1049,28,-4.835
2017-11-17 23:00:00+00:00,0,1033,1033,30,-4.713
2017-11-18 00:00:00+00:00,0,1095,1095,27,-4.734
2017-11-18 01:00:00+00:00,0,1065,1065,24,-4.978
2017-11-18 02:00:00+00:00,0,883,883,24,-5.312
2017-11-18 03:00:00+00:00,0,846,846,24,-5.696
2017-11-18 04:00:00+00:00,0,863,863,22,-5.868
2017-11-18 05:00:00+00:00,0,784,784,18,-5.893
2017-11-18 06:00:00+00:00,14,552,566,20,-5.906
2017-11-18 07:00:00+00:00,61,444,505,28,-4.994
2017-11-18 08:00:00+00:00,143,391,534,27,-2.916
2017-11-18 09:00:00+00:00,216,289,505,23,-1.215
2017-11-18 10:00:00+00:00,260,312,572,19,-0.518
2017-11-18 11:00:00+00:00,263,226,489,15,-0.097
2017-11-18 12:00:00+00:00,232,225,457,11,0.021
2017-11-18 13:00:00+00:00,167,241,408,9,-0.153
2017-11-18 14:00:00+00:00,83,474,557,12,-0.782
2017-11-18 15:00:00+00:00,24,772,796,21,-2.677
2017-11-18 16:00:00+00:00,8,892,900,30,-4.236
2017-11-18 17:00:00+00:00,8,1243,1251,29,-5.023
2017-11-18 18:00:00+00:00,0,1416,1416,27,-5.431
2017-11-18 19:00:00+00:00,0,1323,1323,21,-5.924
2017-11-18 20:00:00+00:00,0,1167,1167,15,-6.359
2017-11-18 21:00:00+00:00,0,1273,1273,14,-6.33
2017-11-18 22:00:00+00:00,0,1487,1487,6,-6.287
2017-11-18 23:00:00+00:00,0,1707,1707,-2,-6.314
2017-11-19 00:00:00+00:00,0,1584,1584,-12,-6.355
2017-11-19 01:00:00+00:00,0,1488,1488,-10,-6.328
2017-11-19 02:00:00+00:00,0,1361,1361,-11,-6.274
2017-11-19 03:00:00+00:00,0,919,919,-24,-6.402
2017-11-19 04:00:00+00:00,0,511,511,-21,-6.499
2017-11-19 05:00:00+00:00,0,407,407,-36,-6.555
2017-11-19 06:00:00+00:00,11,558,569,-22,-6.597
2017-11-19 07:00:00+00:00,47,518,565,-30,-6.388
2017-11-19 08:00:00+00:00,103,566,669,-25,-5.178
2017-11-19 09:00:00+00:00,155,816,971,-17,-3.356
2017-11-19 10:00:00+00:00,186,846,1032,-14,-2.101
2017-11-19 11:00:00+00:00,209,887,1096,-8,-1.776
2017-11-19 12:00:00+00:00,204,1199,1403,-21,-2.03
2017-11-19 13:00:00+00:00,149,1160,1309,-20,-2.645
2017-11-19 14:00:00+00:00,74,1350,1424,-5,-3.527
2017-11-19 15:00:00+00:00,22,1432,1454,3,-4.692
2017-11-19 16:00:00+00:00,8,1653,1661,20,-5.643
2017-11-19 17:00:00+00:00,8,1726,1734,21,-5.963
2017-11-19 18:00:00+00:00,0,2153,2153,23,-6.154
2017-11-19 19:00:00+00:00,0,2308,2308,23,-6.234
2017-11-19 20:00:00+00:00,0,2321,2321,20,-6.186
2017-11-19 21:00:00+00:00,0,2210,2210,24,-6.033
2017-11-19 22:00:00+00:00,0,2253,2253,14,-5.919
2017-11-19 23:00:00+00:00,0,2278,2278,15,-5.823
2017-11-20 00:00:00+00:00,0,2268,2268,12,-5.886
2017-11-20 01:00:00+00:00,0,2340,2340,12,-5.975
2017-11-20 02:00:00+00:00,0,2517,2517,12,-6.028
2017-11-20 03:00:00+00:00,0,2494,2494,14,-6.023
2017-11-20 04:00:00+00:00,0,2337,2337,21,-5.997
2017-11-20 05:00:00+00:00,0,2201,2201,37,-6.015
2017-11-20 06:00:00+00:00,12,1911,1923,46,-6.116
2017-11-20 07:00:00+00:00,52,1849,1901,50,-5.755
2017-11-20 08:00:00+00:00,118,2070,2188,44,-4.672
2017-11-20 09:00:00+00:00,176,2110,2286,43,-3.721
2017-11-20 10:00:00+00:00,211,2156,2367,45,-2.96
2017-11-20 11:00:00+00:00,212,2237,2449,43,-2.473
2017-11-20 12:00:00+00:00,181,2072,2253,44,-2.479
2017-11-20 13:00:00+00:00,128,1739,1867,42,-2.688
2017-11-20 14:00:00+00:00,63,1555,1618,46,-3.051
2017-11-20 15:00:00+00:00,19,1383,1402,48,-4.035
2017-11-20 16:00:00+00:00,8,1589,1597,52,-5.056
2017-11-20 17:00:00+00:00,8,1675,1683,51,-5.655
2017-11-20 18:00:00+00:00,0,1625,1625,47,-5.969
2017-11-20 19:00:00+00:00,0,1431,1431,44,-5.802
2017-11-20 20:00:00+00:00,0,1450,1450,40,-5.662
2017-11-20 21:00:00+00:00,0,1190,1190,36,-5.59
2017-11-20 22:00:00+00:00,0,1084,1084,31,-5.559
2017-11-20 23:00:00+00:00,0,665,665,33,-5.661
2017-11-21 00:00:00+00:00,0,337,337,33,-5.669
2017-11-21 01:00:00+00:00,0,310,310,33,-5.583
2017-11-21 02:00:00+00:00,0,364,364,33,-5.357
2017-11-21 03:00:00+00:00,0,345,345,34,-5.04
2017-11-21 04:00:00+00:00,0,363,363,36,-4.32
2017-11-21 05:00:00+00:00,0,339,339,48,-4.171
2017-11-21 06:00:00+00:00,11,352,363,61,-3.857
2017-11-21 07:00:00+00:00,43,308,351,65,-2.967
2017-11-21 08:00:00+00:00,99,308,407,65,-0.864
2017-11-21 09:00:00+00:00,150,299,449,65,0.634
2017-11-21 10:00:00+00:00,180,325,505,66,0.917
2017-11-21 11:00:00+00:00,183,353,536,64,1.036
2017-11-21 12:00:00+00:00,155,421,576,63,1.072
2017-11-21 13:00:00+00:00,110,608,718,59,0.947
2017-11-21 14:00:00+00:00,58,789,847,60,0.636
2017-11-21 15:00:00+00:00,19,937,956,62,0.342
2017-11-21 16:00:00+00:00,8,967,975,67,0.254
2017-11-21 17:00:00+00:00,8,981,989,54,0.262
2017-11-21 18:00:00+00:00,0,1013,1013,49,0.277
2017-11-21 19:00:00+00:00,0,1021,1021,40,-0.163
2017-11-21 20:00:00+00:00,0,1039,1039,35,-0.747
2017-11-21 21:00:00+00:00,0,773,773,33,-0.977
2017-11-21 22:00:00+00:00,0,613,613,26,-1.055
2017-11-21 23:00:00+00:00,0,442,442,24,-0.839
2017-11-22 00:00:00+00:00,0,415,415,18,-0.929
2017-11-22 01:00:00+00:00,0,511,511,16,-0.992
2017-11-22 02:00:00+00:00,0,539,539,14,-1.214
2017-11-22 03:00:00+00:00,0,624,624,17,-1.511
2017-11-22 04:00:00+00:00,0,818,818,20,-1.684
2017-11-22 05:00:00+00:00,0,768,768,30,-1.721
2017-11-22 06:00:00+00:00,15,582,597,41,-1.629
2017-11-22 07:00:00+00:00,67,532,599,40,-1.05
2017-11-22 08:00:00+00:00,158,442,600,36,0.332
2017-11-22 09:00:00+00:00,246,330,576,35,2.177
2017-11-22 10:00:00+00:00,304,348,652,35,2.997
2017-11-22 11:00:00+00:00,317,340,657,34,3.4
2017-11-22 12:00:00+00:00,276,409,685,34,3.599
2017-11-22 13:00:00+00:00,194,415,609,35,3.273
2017-11-22 14:00:00+00:00,94,439,533,38,2.67
2017-11-22 15:00:00+00:00,26,410,436,44,1.723
2017-11-22 16:00:00+00:00,8,321,329,53,0.183
2017-11-22 17:00:00+00:00,8,237,245,48,-1.11
2017-11-22 18:00:00+00:00,0,178,178,44,-2.212
2017-11-22 19:00:00+00:00,0,108,108,34,-3.23
2017-11-22 20:00:00+00:00,0,64,64,31,-4.015
2017-11-22 21:00:00+00:00,0,62,62,30,-4.625
2017-11-22 22:00:00+00:00,0,88,88,24,-5.048
2017-11-22 23:00:00+00:00,0,130,130,17,-5.373
2017-11-23 00:00:00+00:00,0,196,196,15,-5.716
2017-11-23 01:00:00+00:00,0,270,270,10,-5.832
2017-11-23 02:00:00+00:00,0,310,310,11,-5.652
2017-11-23 03:00:00+00:00,0,392,392,11,-5.21
2017-11-23 04:00:00+00:00,0,511,511,17,-4.912
2017-11-23 05:00:00+00:00,0,490,490,28,-4.82
2017-11-23 06:00:00+00:00,12,625,637,36,-4.963
2017-11-23 07:00:00+00:00,51,574,625,36,-4.173
2017-11-23 08:00:00+00:00,118,545,663,31,-1.988
2017-11-23 09:00:00+00:00,184,488,672,25,0.95
2017-11-23 10:00:00+00:00,232,356,588,22,2.022
2017-11-23 11:00:00+00:00,258,256,514,19,2.273
2017-11-23 12:00:00+00:00,241,182,423,21,2.41
2017-11-23 13:00:00+00:00,171,125,296,23,2.288
2017-11-23 14:00:00+00:00,81,162,243,27,1.918
2017-11-23 15:00:00+00:00,23,234,257,34,1.829
2017-11-23 16:00:00+00:00,8,196,204,40,1.705
2017-11-23 17:00:00+00:00,8,208,216,37,1.783
2017-11-23 18:00:00+00:00,0,186,186,35,1.951
2017-11-23 19:00:00+00:00,0,157,157,36,2.1
2017-11-23 20:00:00+00:00,0,143,143,31,2.103
2017-11-23 21:00:00+00:00,0,149,149,28,1.756
2017-11-23 22:00:00+00:00,0,150,150,22,1.152
2017-11-23 23:00:00+00:00,0,135,135,26,0.473
2017-11-24 00:00:00+00:00,0,119,119,25,-0.126
2017-11-24 01:00:00+00:00,0,88,88,25,-0.693
2017-11-24 02:00:00+00:00,0,72,72,26,-1.146
2017-11-24 03:00:00+00:00,0,46,46,28,-1.561
2017-11-24 04:00:00+00:00,0,20,20,31,-1.913
2017-11-24 05:00:00+00:00,0,21,21,38,-2.248
2017-11-24 06:00:00+00:00,11,56,67,49,-2.603
2017-11-24 07:00:00+00:00,51,96,147,50,-2.114
2017-11-24 08:00:00+00:00,128,87,215,45,-0.467
2017-11-24 09:00:00+00:00,214,84,298,43,1.51
2017-11-24 10:00:00+00:00,278,145,423,42,2.385
2017-11-24 11:00:00+00:00,295,194,489,41,2.767
2017-11-24 12:00:00+00:00,257,239,496,41,2.846
2017-11-24 13:00:00+00:00,175,283,458,42,2.31
2017-11-24 14:00:00+00:00,80,386,466,47,1.189
2017-11-24 15:00:00+00:00,22,418,440,52,0.281
2017-11-24 16:00:00+00:00,8,427,435,60,-0.177
2017-11-24 17:00:00+00:00,8,418,426,58,-0.125
2017-11-24 18:00:00+00:00,0,392,392,55,-0.038
2017-11-24 19:00:00+00:00,0,454,454,49,0.03
2017-11-24 20:00:00+00:00,0,402,402,44,0.061
2017-11-24 21:00:00+00:00,0,349,349,43,0.162
2017-11-24 22:00:00+00:00,0,391,391,39,0.226
2017-11-24 23:00:00+00:00,0,334,334,40,-0.122
2017-11-25 00:00:00+00:00,0,313,313,38,-1.051
2017-11-25 01:00:00+00:00,0,322,322,38,-2.337
2017-11-25 02:00:00+00:00,0,404,404,36,-3.442
2017-11-25 03:00:00+00:00,0,478,478,36,-4.22
2017-11-25 04:00:00+00:00,0,528,528,36,-4.775
2017-11-25 05:00:00+00:00,0,718,718,36,-4.552
2017-11-25 06:00:00+00:00,9,833,842,39,-3.231
2017-11-25 07:00:00+00:00,38,901,939,43,-1.931
2017-11-25 08:00:00+00:00,98,1259,1357,46,-0.548
2017-11-25 09:00:00+00:00,177,1633,1810,46,0.641
2017-11-25 10:00:00+00:00,243,1917,2160,46,1.53
2017-11-25 11:00:00+00:00,263,2027,2290,44,2.002
2017-11-25 12:00:00+00:00,223,1921,2144,41,1.893
2017-11-25 13:00:00+00:00,143,1642,1785,39,1.692
2017-11-25 14:00:00+00:00,63,1367,1430,39,1.017
2017-11-25 15:00:00+00:00,18,1538,1556,40,0.251
2017-11-25 16:00:00+00:00,8,1745,1753,46,0.001
2017-11-25 17:00:00+00:00,8,1951,1959,43,-0.861
2017-11-25 18:00:00+00:00,0,1883,1883,39,-1.089
2017-11-25 19:00:00+00:00,0,1678,1678,34,-1.097
2017-11-25 20:00:00+00:00,0,1533,1533,32,-1.949
2017-11-25 21:00:00+00:00,0,1429,1429,32,-2.906
2017-11-25 22:00:00+00:00,0,1265,1265,26,-3.452
2017-11-25 23:00:00+00:00,0,1061,1061,19,-3.719
2017-11-26 00:00:00+00:00,0,987,987,13,-3.914
2017-11-26 01:00:00+00:00,0,1157,1157,12,-4.239
2017-11-26 02:00:00+00:00,0,1042,1042,10,-4.521
2017-11-26 03:00:00+00:00,0,933,933,8,-4.686
2017-11-26 04:00:00+00:00,0,1206,1206,7,-5.002
2017-11-26 05:00:00+00:00,0,1590,1590,6,-5.484
2017-11-26 06:00:00+00:00,10,1710,1720,7,-5.837
2017-11-26 07:00:00+00:00,35,1793,1828,11,-5.87
2017-11-26 08:00:00+00:00,84,1776,1860,14,-5.618
2017-11-26 09:00:00+00:00,133,2012,2145,15,-5.406
2017-11-26 10:00:00+00:00,167,2074,2241,14,-5.295
2017-11-26 11:00:00+00:00,179,1997,2176,12,-5.163
2017-11-26 12:00:00+00:00,162,2031,2193,9,-4.946
2017-11-26 13:00:00+00:00,114,2199,2313,9,-4.936
2017-11-26 14:00:00+00:00,56,2193,2249,12,-5.48
2017-11-26 15:00:00+00:00,18,2024,2042,21,-6.663
2017-11-26 16:00:00+00:00,8,1838,1846,27,-7.349
2017-11-26 17:00:00+00:00,8,1716,1724,27,-7.571
2017-11-26 18:00:00+00:00,0,2058,2058,23,-7.616
2017-11-26 19:00:00+00:00,0,2185,2185,18,-7.528
2017-11-26 20:00:00+00:00,0,1900,1900,18,-7.397
2017-11-26 21:00:00+00:00,0,1742,1742,17,-7.418
2017-11-26 22:00:00+00:00,0,1904,1904,12,-7.509
2017-11-26 23:00:00+00:00,0,1868,1868,12,-7.453
2017-11-27 00:00:00+00:00,0,1614,1614,10,-7.363
2017-11-27 01:00:00+00:00,0,1370,1370,8,-7.36
2017-11-27 02:00:00+00:00,0,1168,1168,9,-7.415
2017-11-27 03:00:00+00:00,0,1010,1010,12,-7.491
2017-11-27 04:00:00+00:00,0,895,895,21,-7.579
2017-11-27 05:00:00+00:00,0,1070,1070,35,-7.642
2017-11-27 06:00:00+00:00,10,1034,1044,45,-7.747
2017-11-27 07:00:00+00:00,41,955,996,44,-7.307
2017-11-27 08:00:00+00:00,110,923,1033,42,-5.959
2017-11-27 09:00:00+00:00,188,800,988,39,-5.06
2017-11-27 10:00:00+00:00,240,862,1102,38,-4.387
2017-11-27 11:00:00+00:00,253,1134,1387,36,-3.937
2017-11-27 12:00:00+00:00,222,1035,1257,35,-3.68
2017-11-27 13:00:00+00:00,153,1068,1221,35,-3.798
2017-11-27 14:00:00+00:00,70,822,892,39,-4.56
2017-11-27 15:00:00+00:00,20,756,776,41,-6.359
2017-11-27 16:00:00+00:00,8,505,513,46,-7.405
2017-11-27 17:00:00+00:00,8,281,289,45,-8.088
2017-11-27 18:00:00+00:00,0,167,167,40,-8.73
2017-11-27 19:00:00+00:00,0,195,195,37,-9.352
2017-11-27 20:00:00+00:00,0,260,260,31,-9.873
2017-11-27 21:00:00+00:00,0,438,438,29,-10.231
2017-11-27 22:00:00+00:00,0,714,714,21,-10.434
2017-11-27 23:00:00+00:00,0,760,760,16,-10.367
2017-11-28 00:00:00+00:00,0,646,646,14,-9.965
2017-11-28 01:00:00+00:00,0,690,690,13,-9.459
2017-11-28 02:00:00+00:00,0,689,689,13,-8.937
2017-11-28 03:00:00+00:00,0,666,666,13,-8.351
2017-11-28 04:00:00+00:00,0,619,619,20,-7.804
2017-11-28 05:00:00+00:00,0,617,617,32,-7.625
2017-11-28 06:00:00+00:00,9,523,532,37,-7.818
2017-11-28 07:00:00+00:00,34,568,602,40,-7.398
2017-11-28 08:00:00+00:00,87,465,552,39,-5.386
2017-11-28 09:00:00+00:00,145,492,637,37,-3.169
2017-11-28 10:00:00+00:00,188,512,700,38,-2.238
2017-11-28 11:00:00+00:00,199,649,848,38,-1.867
2017-11-28 12:00:00+00:00,176,786,962,40,-1.828
2017-11-28 13:00:00+00:00,125,900,1025,45,-2.012
2017-11-28 14:00:00+00:00,58,884,942,48,-2.569
2017-11-28 15:00:00+00:00,17,853,870,55,-3.434
2017-11-28 16:00:00+00:00,8,751,759,66,-3.865
2017-11-28 17:00:00+00:00,8,852,860,64,-4.107
2017-11-28 18:00:00+00:00,0,770,770,58,-4.334
2017-11-28 19:00:00+00:00,0,616,616,54,-4.604
2017-11-28 20:00:00+00:00,0,555,555,45,-4.863
2017-11-28 21:00:00+00:00,0,579,579,42,-5.048
2017-11-28 22:00:00+00:00,0,542,542,36,-5.131
2017-11-28 23:00:00+00:00,0,484,484,35,-5.176
2017-11-29 00:00:00+00:00,0,390,390,34,-5.215
2017-11-29 01:00:00+00:00,0,222,222,34,-5.187
2017-11-29 02:00:00+00:00,0,130,130,34,-5.047
2017-11-29 03:00:00+00:00,0,102,102,36,-4.996
2017-11-29 04:00:00+00:00,0,81,81,38,-4.906
2017-11-29 05:00:00+00:00,0,54,54,58,-4.868
2017-11-29 06:00:00+00:00,9,52,61,80,-4.949
2017-11-29 07:00:00+00:00,31,104,135,85,-4.755
2017-11-29 08:00:00+00:00,78,114,192,82,-3.92
2017-11-29 09:00:00+00:00,129,85,214,80,-2.37
2017-11-29 10:00:00+00:00,163,86,249,81,-0.864
2017-11-29 11:00:00+00:00,169,100,269,78,0.077
2017-11-29 12:00:00+00:00,135,106,241,79,0.015
2017-11-29 13:00:00+00:00,92,181,273,77,-0.793
2017-11-29 14:00:00+00:00,45,269,314,79,-1.629
2017-11-29 15:00:00+00:00,15,359,374,90,-2.466
2017-11-29 16:00:00+00:00,8,309,317,115,-3.068
2017-11-29 17:00:00+00:00,8,371,379,111,-3.375
2017-11-29 18:00:00+00:00,0,370,370,89,-3.554
2017-11-29 19:00:00+00:00,0,532,532,77,-3.775
2017-11-29 20:00:00+00:00,0,630,630,61,-4.222
2017-11-29 21:00:00+00:00,0,669,669,52,-4.899
2017-11-29 22:00:00+00:00,0,657,657,41,-5.697
2017-11-29 23:00:00+00:00,0,577,577,43,-6.47
2017-11-30 00:00:00+00:00,0,473,473,42,-7.122
2017-11-30 01:00:00+00:00,0,397,397,40,-7.41
2017-11-30 02:00:00+00:00,0,342,342,39,-7.275
2017-11-30 03:00:00+00:00,0,289,289,40,-7.115
2017-11-30 04:00:00+00:00,0,248,248,43,-6.853
2017-11-30 05:00:00+00:00,0,274,274,59,-6.711
2017-11-30 06:00:00+00:00,9,251,260,86,-6.77
2017-11-30 07:00:00+00:00,20,345,365,99,-6.741
2017-11-30 08:00:00+00:00,49,444,493,95,-6.528
2017-11-30 09:00:00+00:00,80,669,749,93,-6.598
2017-11-30 10:00:00+00:00,99,994,1093,93,-6.581
2017-11-30 11:00:00+00:00,107,1152,1259,84,-6.36
2017-11-30 12:00:00+00:00,94,1434,1528,85,-6.059
2017-11-30 13:00:00+00:00,67,1772,1839,85,-5.794
2017-11-30 14:00:00+00:00,32,1958,1990,88,-5.772
2017-11-30 15:00:00+00:00,12,1923,1935,95,-6.362
2017-11-30 16:00:00+00:00,8,1601,1609,115,-7.275
2017-11-30 17:00:00+00:00,8,1371,1379,107,-7.601
2017-11-30 18:00:00+00:00,0,1228,1228,88,-7.641
2017-11-30 19:00:00+00:00,0,996,996,70,-7.593
2017-11-30 20:00:00+00:00,0,815,815,57,-7.635
2017-11-30 21:00:00+00:00,0,647,647,50,-7.956
2017-11-30 22:00:00+00:00,0,592,592,41,-8.345
2017-11-30 23:00:00+00:00,0,630,630,38,-8.814
2017-12-01 00:00:00+00:00,0,690,690,38,-9.413
2017-12-01 01:00:00+00:00,0,534,534,37,-10.145
2017-12-01 02:00:00+00:00,0,447,447,36,-10.821
2017-12-01 03:00:00+00:00,0,340,340,37,-11.39
2017-12-01 04:00:00+00:00,0,229,229,38,-11.942
2017-12-01 05:00:00+00:00,0,81,81,55,-12.47
2017-12-01 06:00:00+00:00,9,31,40,81,-12.908
2017-12-01 07:00:00+00:00,30,20,50,91,-12.706
2017-12-01 08:00:00+00:00,77,15,92,90,-10.423
2017-12-01 09:00:00+00:00,128,8,136,87,-7.294
2017-12-01 10:00:00+00:00,166,7,173,83,-5.535
2017-12-01 11:00:00+00:00,180,6,186,80,-4.867
2017-12-01 12:00:00+00:00,161,7,168,78,-4.667
2017-12-01 13:00:00+00:00,113,5,118,79,-4.762
2017-12-01 14:00:00+00:00,53,13,66,81,-5.369
2017-12-01 15:00:00+00:00,16,14,30,87,-6.707
2017-12-01 16:00:00+00:00,8,7,15,101,-7.732
2017-12-01 17:00:00+00:00,8,5,13,95,-8.408
2017-12-01 18:00:00+00:00,0,10,10,83,-8.984
2017-12-01 19:00:00+00:00,0,13,13,62,-9.463
2017-12-01 20:00:00+00:00,0,12,12,53,-9.802
2017-12-01 21:00:00+00:00,0,14,14,46,-10.129
2017-12-01 22:00:00+00:00,0,41,41,39,-10.378
2017-12-01 23:00:00+00:00,0,92,92,42,-10.467
2017-12-02 00:00:00+00:00,0,148,148,39,-10.552
2017-12-02 01:00:00+00:00,0,140,140,38,-10.665
2017-12-02 02:00:00+00:00,0,101,101,37,-10.869
2017-12-02 03:00:00+00:00,0,133,133,38,-10.995
2017-12-02 04:00:00+00:00,0,211,211,38,-11.13
2017-12-02 05:00:00+00:00,0,272,272,38,-11.369
2017-12-02 06:00:00+00:00,14,313,327,42,-11.725
2017-12-02 07:00:00+00:00,66,319,385,48,-11.68
2017-12-02 08:00:00+00:00,158,422,580,48,-10.119
2017-12-02 09:00:00+00:00,254,489,743,47,-7.735
2017-12-02 10:00:00+00:00,323,589,912,46,-6.431
2017-12-02 11:00:00+00:00,339,652,991,43,-5.729
2017-12-02 12:00:00+00:00,297,730,1027,41,-5.457
2017-12-02 13:00:00+00:00,213,848,1061,39,-5.551
2017-12-02 14:00:00+00:00,99,854,953,42,-6.185
2017-12-02 15:00:00+00:00,25,873,898,50,-7.813
2017-12-02 16:00:00+00:00,8,833,841,52,-9.101
2017-12-02 17:00:00+00:00,8,899,907,50,-9.848
2017-12-02 18:00:00+00:00,0,1105,1105,45,-10.357
2017-12-02 19:00:00+00:00,0,1042,1042,41,-10.842
2017-12-02 20:00:00+00:00,0,976,976,37,-11.245
2017-12-02 21:00:00+00:00,0,850,850,36,-11.804
2017-12-02 22:00:00+00:00,0,797,797,31,-12.378
2017-12-02 23:00:00+00:00,0,820,820,30,-12.894
2017-12-03 00:00:00+00:00,0,953,953,27,-13.421
2017-12-03 01:00:00+00:00,0,1244,1244,25,-13.794
2017-12-03 02:00:00+00:00,0,1232,1232,24,-13.9
2017-12-03 03:00:00+00:00,0,1051,1051,24,-13.804
2017-12-03 04:00:00+00:00,0,1136,1136,23,-13.797
2017-12-03 05:00:00+00:00,0,1264,1264,23,-13.837
2017-12-03 06:00:00+00:00,9,1594,1603,25,-13.85
2017-12-03 07:00:00+00:00,29,1810,1839,29,-13.276
2017-12-03 08:00:00+00:00,82,1754,1836,30,-11.177
2017-12-03 09:00:00+00:00,144,1948,2092,33,-9.335
2017-12-03 10:00:00+00:00,189,2020,2209,36,-8.28
2017-12-03 11:00:00+00:00,204,2083,2287,33,-7.567
2017-12-03 12:00:00+00:00,181,2159,2340,31,-7.228
2017-12-03 13:00:00+00:00,126,2188,2314,31,-7.364
2017-12-03 14:00:00+00:00,55,2145,2200,31,-8.16
2017-12-03 15:00:00+00:00,16,2070,2086,36,-9.706
2017-12-03 16:00:00+00:00,8,1891,1899,40,-10.629
2017-12-03 17:00:00+00:00,8,1790,1798,41,-11.348
2017-12-03 18:00:00+00:00,0,1705,1705,38,-12.114
2017-12-03 19:00:00+00:00,0,1491,1491,33,-13.254
2017-12-03 20:00:00+00:00,0,1402,1402,31,-14.248
2017-12-03 21:00:00+00:00,0,1127,1127,31,-15.031
2017-12-03 22:00:00+00:00,0,1130,1130,25,-15.738
2017-12-03 23:00:00+00:00,0,1000,1000,18,-15.956
2017-12-04 00:00:00+00:00,0,1051,1051,14,-15.73
2017-12-04 01:00:00+00:00,0,1047,1047,11,-14.947
2017-12-04 02:00:00+00:00,0,1013,1013,10,-13.767
2017-12-04 03:00:00+00:00,0,1109,1109,11,-12.71
2017-12-04 04:00:00+00:00,0,1143,1143,20,-11.55
2017-12-04 05:00:00+00:00,0,1090,1090,37,-10.337
2017-12-04 06:00:00+00:00,9,1200,1209,43,-9.706
2017-12-04 07:00:00+00:00,24,1341,1365,45,-8.74
2017-12-04 08:00:00+00:00,61,1371,1432,43,-6.865
2017-12-04 09:00:00+00:00,103,1438,1541,43,-5.57
2017-12-04 10:00:00+00:00,134,1488,1622,42,-4.438
2017-12-04 11:00:00+00:00,145,1635,1780,41,-3.514
2017-12-04 12:00:00+00:00,132,1444,1576,42,-3.11
2017-12-04 13:00:00+00:00,95,1438,1533,43,-3.134
2017-12-04 14:00:00+00:00,44,1719,1763,47,-3.444
2017-12-04 15:00:00+00:00,14,1728,1742,50,-3.949
2017-12-04 16:00:00+00:00,8,1678,1686,55,-4.311
2017-12-04 17:00:00+00:00,8,1778,1786,52,-4.523
2017-12-04 18:00:00+00:00,0,2035,2035,48,-4.673
2017-12-04 19:00:00+00:00,0,2109,2109,42,-4.813
2017-12-04 20:00:00+00:00,0,2111,2111,37,-4.946
2017-12-04 21:00:00+00:00,0,2058,2058,34,-5.085
2017-12-04 22:00:00+00:00,0,2051,2051,29,-5.208
2017-12-04 23:00:00+00:00,0,1907,1907,29,-5.284
2017-12-05 00:00:00+00:00,0,1847,1847,27,-5.273
2017-12-05 01:00:00+00:00,0,1538,1538,25,-5.198
2017-12-05 02:00:00+00:00,0,1365,1365,24,-5.067
2017-12-05 03:00:00+00:00,0,1443,1443,24,-4.964
2017-12-05 04:00:00+00:00,0,1523,1523,29,-4.92
2017-12-05 05:00:00+00:00,0,1190,1190,38,-4.945
2017-12-05 06:00:00+00:00,9,1024,1033,45,-5.043
2017-12-05 07:00:00+00:00,24,1103,1127,45,-5.035
2017-12-05 08:00:00+00:00,64,1349,1413,42,-4.373
2017-12-05 09:00:00+00:00,114,1576,1690,43,-3.565
2017-12-05 10:00:00+00:00,150,1926,2076,41,-2.93
2017-12-05 11:00:00+00:00,161,2091,2252,39,-2.428
2017-12-05 12:00:00+00:00,143,2218,2361,40,-2.145
2017-12-05 13:00:00+00:00,101,2245,2346,40,-2.208
2017-12-05 14:00:00+00:00,46,2185,2231,41,-2.931
2017-12-05 15:00:00+00:00,14,2068,2082,43,-5.503
2017-12-05 16:00:00+00:00,8,1879,1887,46,-7.679
2017-12-05 17:00:00+00:00,8,1693,1701,43,-8.82
2017-12-05 18:00:00+00:00,0,1884,1884,39,-9.504
2017-12-05 19:00:00+00:00,0,1943,1943,36,-9.766
2017-12-05 20:00:00+00:00,0,1825,1825,32,-9.936
2017-12-05 21:00:00+00:00,0,1820,1820,27,-9.933
2017-12-05 22:00:00+00:00,0,1956,1956,18,-9.872
2017-12-05 23:00:00+00:00,0,2038,2038,11,-9.632
2017-12-06 00:00:00+00:00,0,1988,1988,10,-9.427
2017-12-06 01:00:00+00:00,0,1993,1993,7,-9.385
2017-12-06 02:00:00+00:00,0,1974,1974,7,-9.169
2017-12-06 03:00:00+00:00,0,1938,1938,10,-9.067
2017-12-06 04:00:00+00:00,0,1841,1841,16,-9.125
2017-12-06 05:00:00+00:00,0,1770,1770,30,-9.28
2017-12-06 06:00:00+00:00,9,1803,1812,36,-9.334
2017-12-06 07:00:00+00:00,35,1766,1801,38,-8.797
2017-12-06 08:00:00+00:00,96,1737,1833,36,-6.546
2017-12-06 09:00:00+00:00,169,1723,1892,37,-2.776
2017-12-06 10:00:00+00:00,221,1833,2054,37,-0.797
2017-12-06 11:00:00+00:00,231,1905,2136,35,-0.173
2017-12-06 12:00:00+00:00,200,1807,2007,36,0.177
2017-12-06 13:00:00+00:00,140,1670,1810,37,0.123
2017-12-06 14:00:00+00:00,63,1645,1708,39,-0.968
2017-12-06 15:00:00+00:00,17,1593,1610,41,-2.895
2017-12-06 16:00:00+00:00,8,1488,1496,45,-4.456
2017-12-06 17:00:00+00:00,8,1473,1481,45,-5.389
2017-12-06 18:00:00+00:00,0,1491,1491,44,-6.088
2017-12-06 19:00:00+00:00,0,1405,1405,38,-6.55
2017-12-06 20:00:00+00:00,0,1369,1369,34,-6.757
2017-12-06 21:00:00+00:00,0,1096,1096,32,-6.874
2017-12-06 22:00:00+00:00,0,897,897,25,-6.68
2017-12-06 23:00:00+00:00,0,799,799,25,-6.54
2017-12-07 00:00:00+00:00,0,717,717,24,-6.434
2017-12-07 01:00:00+00:00,0,659,659,22,-6.366
2017-12-07 02:00:00+00:00,0,509,509,23,-6.295
2017-12-07 03:00:00+00:00,0,451,451,24,-6.135
2017-12-07 04:00:00+00:00,0,399,399,26,-5.991
2017-12-07 05:00:00+00:00,0,317,317,36,-5.818
2017-12-07 06:00:00+00:00,9,303,312,44,-5.601
2017-12-07 07:00:00+00:00,33,246,279,40,-5.092
2017-12-07 08:00:00+00:00,97,214,311,37,-3.712
2017-12-07 09:00:00+00:00,173,206,379,34,-1.359
2017-12-07 10:00:00+00:00,228,180,408,32,0.156
2017-12-07 11:00:00+00:00,244,175,419,30,0.435
2017-12-07 12:00:00+00:00,214,172,386,31,0.455
2017-12-07 13:00:00+00:00,146,198,344,31,0.292
2017-12-07 14:00:00+00:00,64,309,373,33,-0.42
2017-12-07 15:00:00+00:00,17,497,514,34,-2.345
2017-12-07 16:00:00+00:00,8,625,633,36,-4.057
2017-12-07 17:00:00+00:00,8,613,621,33,-5.278
2017-12-07 18:00:00+00:00,0,564,564,31,-6.361
2017-12-07 19:00:00+00:00,0,478,478,26,-7.519
2017-12-07 20:00:00+00:00,0,550,550,22,-8.664
2017-12-07 21:00:00+00:00,0,712,712,20,-9.529
2017-12-07 22:00:00+00:00,0,805,805,14,-10.252
2017-12-07 23:00:00+00:00,0,768,768,21,-10.531
2017-12-08 00:00:00+00:00,0,724,724,21,-10.89
2017-12-08 01:00:00+00:00,0,697,697,19,-11.47
2017-12-08 02:00:00+00:00,0,601,601,23,-11.736
2017-12-08 03:00:00+00:00,0,518,518,26,-11.004
2017-12-08 04:00:00+00:00,0,529,529,30,-9.544
2017-12-08 05:00:00+00:00,0,451,451,38,-8.309
2017-12-08 06:00:00+00:00,9,364,373,44,-7.408
2017-12-08 07:00:00+00:00,26,259,285,44,-6.447
2017-12-08 08:00:00+00:00,67,254,321,43,-4.493
2017-12-08 09:00:00+00:00,116,238,354,43,-2.92
2017-12-08 10:00:00+00:00,148,211,359,39,-1.931
2017-12-08 11:00:00+00:00,156,227,383,36,-1.478
2017-12-08 12:00:00+00:00,141,209,350,35,-1.338
2017-12-08 13:00:00+00:00,101,191,292,35,-1.371
2017-12-08 14:00:00+00:00,46,188,234,38,-1.85
2017-12-08 15:00:00+00:00,14,208,222,40,-3.124
2017-12-08 16:00:00+00:00,8,504,512,44,-4.536
2017-12-08 17:00:00+00:00,8,681,689,41,-5.48
2017-12-08 18:00:00+00:00,0,739,739,37,-6.208
2017-12-08 19:00:00+00:00,0,906,906,34,-6.642
2017-12-08 20:00:00+00:00,0,789,789,32,-7.028
2017-12-08 21:00:00+00:00,0,1057,1057,29,-7.114
2017-12-08 22:00:00+00:00,0,1191,1191,23,-7.389
2017-12-08 23:00:00+00:00,0,1562,1562,11,-8.225
2017-12-09 00:00:00+00:00,0,1606,1606,7,-8.703
2017-12-09 01:00:00+00:00,0,1249,1249,4,-9.05
2017-12-09 02:00:00+00:00,0,1102,1102,4,-9.357
2017-12-09 03:00:00+00:00,0,1185,1185,2,-9.193
2017-12-09 04:00:00+00:00,0,1141,1141,3,-8.964
2017-12-09 05:00:00+00:00,0,1331,1331,5,-9.054
2017-12-09 06:00:00+00:00,9,1373,1382,11,-9.068
2017-12-09 07:00:00+00:00,23,1441,1464,15,-9.153
2017-12-09 08:00:00+00:00,64,1714,1778,19,-8.898
2017-12-09 09:00:00+00:00,112,1985,2097,20,-8.758
2017-12-09 10:00:00+00:00,144,2114,2258,20,-8.607
2017-12-09 11:00:00+00:00,151,2418,2569,19,-8.404
2017-12-09 12:00:00+00:00,135,2447,2582,17,-8.314
2017-12-09 13:00:00+00:00,97,2219,2316,17,-8.478
2017-12-09 14:00:00+00:00,45,2099,2144,22,-9.02
2017-12-09 15:00:00+00:00,14,2116,2130,30,-10.287
2017-12-09 16:00:00+00:00,8,2432,2440,31,-11.775
2017-12-09 17:00:00+00:00,8,2394,2402,29,-13.679
2017-12-09 18:00:00+00:00,0,2232,2232,26,-15.212
2017-12-09 19:00:00+00:00,0,2235,2235,18,-16.036
2017-12-09 20:00:00+00:00,0,2448,2448,15,-16.244
2017-12-09 21:00:00+00:00,0,2231,2231,15,-16.007
2017-12-09 22:00:00+00:00,0,2038,2038,8,-15.892
2017-12-09 23:00:00+00:00,0,1711,1711,7,-16.114
2017-12-10 00:00:00+00:00,0,1423,1423,6,-16.805
2017-12-10 01:00:00+00:00,0,1262,1262,6,-17.18
2017-12-10 02:00:00+00:00,0,933,933,7,-17.267
2017-12-10 03:00:00+00:00,0,630,630,10,-16.739
2017-12-10 04:00:00+00:00,0,456,456,11,-16.131
2017-12-10 05:00:00+00:00,0,339,339,13,-15.939
2017-12-10 06:00:00+00:00,9,296,305,15,-16.779
2017-12-10 07:00:00+00:00,24,464,488,22,-17.478
2017-12-10 08:00:00+00:00,71,731,802,24,-15.022
2017-12-10 09:00:00+00:00,129,1269,1398,26,-11.246
2017-12-10 10:00:00+00:00,173,1884,2057,28,-9.147
2017-12-10 11:00:00+00:00,186,2182,2368,28,-8.034
2017-12-10 12:00:00+00:00,158,2400,2558,24,-7.867
2017-12-10 13:00:00+00:00,104,2502,2606,22,-7.854
2017-12-10 14:00:00+00:00,45,2543,2588,19,-7.732
2017-12-10 15:00:00+00:00,14,2501,2515,21,-7.314
2017-12-10 16:00:00+00:00,8,2447,2455,21,-6.679
2017-12-10 17:00:00+00:00,8,2275,2283,20,-6.172
2017-12-10 18:00:00+00:00,0,2164,2164,20,-5.859
2017-12-10 19:00:00+00:00,0,2296,2296,13,-5.573
2017-12-10 20:00:00+00:00,0,2257,2257,11,-5.136
2017-12-10 21:00:00+00:00,0,2150,2150,14,-4.683
2017-12-10 22:00:00+00:00,0,2303,2303,7,-4.341
2017-12-10 23:00:00+00:00,0,2267,2267,13,-3.999
2017-12-11 00:00:00+00:00,0,2298,2298,16,-3.487
2017-12-11 01:00:00+00:00,0,2326,2326,15,-3.037
2017-12-11 02:00:00+00:00,0,2313,2313,18,-2.66
2017-12-11 03:00:00+00:00,0,2278,2278,25,-2.104
2017-12-11 04:00:00+00:00,0,2208,2208,31,-1.716
2017-12-11 05:00:00+00:00,0,2242,2242,46,-1.522
2017-12-11 06:00:00+00:00,8,2279,2287,60,-1.395
2017-12-11 07:00:00+00:00,27,2242,2269,57,-1.27
2017-12-11 08:00:00+00:00,77,2383,2460,57,-0.807
2017-12-11 09:00:00+00:00,141,2465,2606,55,-0.086
2017-12-11 10:00:00+00:00,189,2374,2563,55,0.675
2017-12-11 11:00:00+00:00,203,2402,2605,48,1.102
2017-12-11 12:00:00+00:00,179,2365,2544,47,1.371
2017-12-11 13:00:00+00:00,123,2229,2352,47,1.426
2017-12-11 14:00:00+00:00,56,2266,2322,49,1.489
2017-12-11 15:00:00+00:00,17,2327,2344,47,1.409
2017-12-11 16:00:00+00:00,8,2365,2373,48,1.393
2017-12-11 17:00:00+00:00,8,2042,2050,44,1.47
2017-12-11 18:00:00+00:00,0,2103,2103,40,1.533
2017-12-11 19:00:00+00:00,0,2159,2159,34,1.688
2017-12-11 20:00:00+00:00,0,2171,2171,28,1.824
2017-12-11 21:00:00+00:00,0,2174,2174,23,1.884
2017-12-11 22:00:00+00:00,0,2082,2082,13,1.823
2017-12-11 23:00:00+00:00,0,2122,2122,25,1.638
2017-12-12 00:00:00+00:00,0,2286,2286,23,0.749
2017-12-12 01:00:00+00:00,0,2319,2319,20,0.65
2017-12-12 02:00:00+00:00,0,2302,2302,18,0.842
2017-12-12 03:00:00+00:00,0,1887,1887,17,0.998
2017-12-12 04:00:00+00:00,0,1693,1693,22,0.603
2017-12-12 05:00:00+00:00,0,1940,1940,30,0.517
2017-12-12 06:00:00+00:00,9,1791,1800,37,0.623
2017-12-12 07:00:00+00:00,28,1263,1291,39,0.804
2017-12-12 08:00:00+00:00,71,636,707,38,0.541
2017-12-12 09:00:00+00:00,115,614,729,38,0.438
2017-12-12 10:00:00+00:00,143,597,740,39,0.278
2017-12-12 11:00:00+00:00,147,580,727,38,0.105
2017-12-12 12:00:00+00:00,127,712,839,37,-0.109
2017-12-12 13:00:00+00:00,91,962,1053,41,-0.36
2017-12-12 14:00:00+00:00,44,1115,1159,44,-0.624
2017-12-12 15:00:00+00:00,15,1272,1287,49,-0.991
2017-12-12 16:00:00+00:00,8,1327,1335,52,-1.291
2017-12-12 17:00:00+00:00,8,1293,1301,50,-1.496
2017-12-12 18:00:00+00:00,0,1256,1256,47,-1.979
2017-12-12 19:00:00+00:00,0,844,844,44,-2.732
2017-12-12 20:00:00+00:00,0,774,774,40,-3.039
2017-12-12 21:00:00+00:00,0,588,588,36,-3.315
2017-12-12 22:00:00+00:00,0,440,440,30,-3.656
2017-12-12 23:00:00+00:00,0,379,379,29,-4.445
2017-12-13 00:00:00+00:00,0,449,449,26,-4.964
2017-12-13 01:00:00+00:00,0,554,554,22,-5.482
2017-12-13 02:00:00+00:00,0,527,527,23,-5.987
2017-12-13 03:00:00+00:00,0,491,491,23,-6.27
2017-12-13 04:00:00+00:00,0,518,518,29,-6.399
2017-12-13 05:00:00+00:00,0,497,497,35,-6.475
2017-12-13 06:00:00+00:00,9,462,471,38,-6.436
2017-12-13 07:00:00+00:00,25,420,445,40,-6.475
2017-12-13 08:00:00+00:00,72,302,374,36,-5.917
2017-12-13 09:00:00+00:00,133,165,298,34,-4.401
2017-12-13 10:00:00+00:00,176,86,262,34,-3.496
2017-12-13 11:00:00+00:00,189,64,253,33,-2.983
2017-12-13 12:00:00+00:00,166,61,227,34,-2.752
2017-12-13 13:00:00+00:00,115,63,178,36,-2.91
2017-12-13 14:00:00+00:00,51,204,255,38,-3.729
2017-12-13 15:00:00+00:00,16,676,692,37,-5.794
2017-12-13 16:00:00+00:00,8,1394,1402,39,-7.125
2017-12-13 17:00:00+00:00,8,1862,1870,37,-7.574
2017-12-13 18:00:00+00:00,0,1912,1912,34,-7.458
2017-12-13 19:00:00+00:00,0,1980,1980,30,-7.391
2017-12-13 20:00:00+00:00,0,2059,2059,25,-7.351
2017-12-13 21:00:00+00:00,0,2065,2065,20,-6.981
2017-12-13 22:00:00+00:00,0,2008,2008,8,-6.601
2017-12-13 23:00:00+00:00,0,1952,1952,8,-6.567
2017-12-14 00:00:00+00:00,0,1817,1817,7,-6.464
2017-12-14 01:00:00+00:00,0,1766,1766,7,-6.153
2017-12-14 02:00:00+00:00,0,1816,1816,5,-5.506
2017-12-14 03:00:00+00:00,0,1734,1734,8,-4.901
2017-12-14 04:00:00+00:00,0,1450,1450,12,-4.63
2017-12-14 05:00:00+00:00,0,1261,1261,29,-4.48
2017-12-14 06:00:00+00:00,8,995,1003,37,-4.834
2017-12-14 07:00:00+00:00,28,719,747,39,-5.153
2017-12-14 08:00:00+00:00,81,690,771,37,-3.817
2017-12-14 09:00:00+00:00,145,936,1081,32,-2.265
2017-12-14 10:00:00+00:00,182,1331,1513,32,-1.567
2017-12-14 11:00:00+00:00,190,2046,2236,31,-1.156
2017-12-14 12:00:00+00:00,154,2050,2204,32,-1.056
2017-12-14 13:00:00+00:00,98,1333,1431,35,-1.29
2017-12-14 14:00:00+00:00,46,980,1026,39,-2.371
2017-12-14 15:00:00+00:00,16,482,498,43,-3.998
2017-12-14 16:00:00+00:00,8,332,340,50,-4.971
2017-12-14 17:00:00+00:00,8,365,373,50,-5.695
2017-12-14 18:00:00+00:00,0,620,620,50,-6.304
2017-12-14 19:00:00+00:00,0,926,926,47,-6.804
2017-12-14 20:00:00+00:00,0,837,837,41,-6.835
2017-12-14 21:00:00+00:00,0,967,967,41,-6.792
2017-12-14 22:00:00+00:00,0,682,682,36,-6.625
2017-12-14 23:00:00+00:00,0,792,792,31,-6.17
2017-12-15 00:00:00+00:00,0,934,934,30,-5.838
2017-12-15 01:00:00+00:00,0,941,941,30,-4.958
2017-12-15 02:00:00+00:00,0,934,934,30,-5.068
2017-12-15 03:00:00+00:00,0,792,792,30,-5.046
2017-12-15 04:00:00+00:00,0,773,773,34,-4.643
2017-12-15 05:00:00+00:00,0,726,726,47,-4.25
2017-12-15 06:00:00+00:00,9,731,740,59,-3.895
2017-12-15 07:00:00+00:00,27,685,712,63,-3.575
2017-12-15 08:00:00+00:00,83,666,749,60,-3.234
2017-12-15 09:00:00+00:00,149,723,872,59,-2.317
2017-12-15 10:00:00+00:00,194,670,864,58,-1.632
2017-12-15 11:00:00+00:00,213,551,764,56,-1.396
2017-12-15 12:00:00+00:00,191,425,616,54,-1.499
2017-12-15 13:00:00+00:00,130,467,597,54,-1.784
2017-12-15 14:00:00+00:00,57,377,434,60,-2.395
2017-12-15 15:00:00+00:00,17,295,312,64,-3.378
2017-12-15 16:00:00+00:00,8,300,308,72,-4.091
2017-12-15 17:00:00+00:00,8,251,259,67,-4.472
2017-12-15 18:00:00+00:00,0,433,433,60,-4.826
2017-12-15 19:00:00+00:00,0,283,283,51,-5.169
2017-12-15 20:00:00+00:00,0,132,132,46,-5.586
2017-12-15 21:00:00+00:00,0,290,290,42,-6.186
2017-12-15 22:00:00+00:00,0,419,419,35,-6.881
2017-12-15 23:00:00+00:00,0,418,418,35,-7.403
2017-12-16 00:00:00+00:00,0,489,489,33,-7.96
2017-12-16 01:00:00+00:00,0,614,614,32,-8.319
2017-12-16 02:00:00+00:00,0,794,794,32,-8.197
2017-12-16 03:00:00+00:00,0,827,827,30,-7.748
2017-12-16 04:00:00+00:00,0,1199,1199,30,-7.512
2017-12-16 05:00:00+00:00,0,1477,1477,32,-7.751
2017-12-16 06:00:00+00:00,8,1240,1248,34,-8.132
2017-12-16 07:00:00+00:00,24,1004,1028,40,-8.294
2017-12-16 08:00:00+00:00,71,783,854,42,-7.488
2017-12-16 09:00:00+00:00,129,608,737,43,-5.157
2017-12-16 10:00:00+00:00,173,671,844,43,-3.879
2017-12-16 11:00:00+00:00,189,592,781,40,-3.38
2017-12-16 12:00:00+00:00,166,421,587,37,-3.218
2017-12-16 13:00:00+00:00,113,304,417,37,-3.336
2017-12-16 14:00:00+00:00,51,238,289,39,-4.107
2017-12-16 15:00:00+00:00,16,276,292,43,-5.17
2017-12-16 16:00:00+00:00,8,282,290,47,-6.277
2017-12-16 17:00:00+00:00,8,220,228,44,-6.949
2017-12-16 18:00:00+00:00,0,198,198,40,-7.551
2017-12-16 19:00:00+00:00,0,189,189,36,-7.649
2017-12-16 20:00:00+00:00,0,204,204,34,-8.043
2017-12-16 21:00:00+00:00,0,237,237,36,-8.779
2017-12-16 22:00:00+00:00,0,542,542,32,-9.419
2017-12-16 23:00:00+00:00,0,863,863,31,-9.862
2017-12-17 00:00:00+00:00,0,886,886,29,-10.012
2017-12-17 01:00:00+00:00,0,858,858,28,-10.144
2017-12-17 02:00:00+00:00,0,818,818,27,-10.299
2017-12-17 03:00:00+00:00,0,907,907,30,-10.619
2017-12-17 04:00:00+00:00,0,857,857,31,-10.936
2017-12-17 05:00:00+00:00,0,792,792,31,-10.784
2017-12-17 06:00:00+00:00,8,703,711,33,-10.525
2017-12-17 07:00:00+00:00,22,606,628,33,-10.067
2017-12-17 08:00:00+00:00,62,557,619,36,-8.483
2017-12-17 09:00:00+00:00,113,504,617,38,-6.302
2017-12-17 10:00:00+00:00,149,512,661,42,-5.464
2017-12-17 11:00:00+00:00,164,623,787,41,-5.176
2017-12-17 12:00:00+00:00,144,727,871,36,-5.174
2017-12-17 13:00:00+00:00,100,668,768,36,-5.426
2017-12-17 14:00:00+00:00,47,514,561,37,-6.039
2017-12-17 15:00:00+00:00,15,511,526,41,-7.182
2017-12-17 16:00:00+00:00,8,522,530,45,-7.904
2017-12-17 17:00:00+00:00,8,606,614,43,-8.3
2017-12-17 18:00:00+00:00,0,936,936,39,-8.609
2017-12-17 19:00:00+00:00,0,1002,1002,37,-8.892
2017-12-17 20:00:00+00:00,0,916,916,34,-9.316
2017-12-17 21:00:00+00:00,0,953,953,34,-9.888
2017-12-17 22:00:00+00:00,0,1127,1127,26,-10.272
2017-12-17 23:00:00+00:00,0,1141,1141,20,-10.639
2017-12-18 00:00:00+00:00,0,1119,1119,18,-10.701
2017-12-18 01:00:00+00:00,0,941,941,18,-10.881
2017-12-18 02:00:00+00:00,0,873,873,17,-11.287
2017-12-18 03:00:00+00:00,0,924,924,20,-11.604
2017-12-18 04:00:00+00:00,0,862,862,25,-11.811
2017-12-18 05:00:00+00:00,0,987,987,40,-11.834
2017-12-18 06:00:00+00:00,8,986,994,50,-11.433
2017-12-18 07:00:00+00:00,20,844,864,48,-10.886
2017-12-18 08:00:00+00:00,56,651,707,48,-9.835
2017-12-18 09:00:00+00:00,101,462,563,48,-7.948
2017-12-18 10:00:00+00:00,136,362,498,48,-7.109
2017-12-18 11:00:00+00:00,149,348,497,48,-6.601
2017-12-18 12:00:00+00:00,133,381,514,50,-6.401
2017-12-18 13:00:00+00:00,97,450,547,50,-6.571
2017-12-18 14:00:00+00:00,48,475,523,53,-7.261
2017-12-18 15:00:00+00:00,15,590,605,55,-8.197
2017-12-18 16:00:00+00:00,8,680,688,66,-9.145
2017-12-18 17:00:00+00:00,8,629,637,62,-10.149
2017-12-18 18:00:00+00:00,0,710,710,57,-11.116
2017-12-18 19:00:00+00:00,0,695,695,54,-12.039
2017-12-18 20:00:00+00:00,0,709,709,47,-12.878
2017-12-18 21:00:00+00:00,0,731,731,44,-13.735
2017-12-18 22:00:00+00:00,0,640,640,38,-14.5
2017-12-18 23:00:00+00:00,0,510,510,40,-15.247
2017-12-19 00:00:00+00:00,0,630,630,37,-15.579
2017-12-19 01:00:00+00:00,0,767,767,36,-15.708
2017-12-19 02:00:00+00:00,0,797,797,36,-15.905
2017-12-19 03:00:00+00:00,0,885,885,36,-15.965
2017-12-19 04:00:00+00:00,0,985,985,41,-15.889
2017-12-19 05:00:00+00:00,0,1186,1186,56,-15.884
2017-12-19 06:00:00+00:00,8,1224,1232,80,-15.971
2017-12-19 07:00:00+00:00,19,1040,1059,84,-15.874
2017-12-19 08:00:00+00:00,60,800,860,80,-13.894
2017-12-19 09:00:00+00:00,116,680,796,78,-10.279
2017-12-19 10:00:00+00:00,158,726,884,76,-7.884
2017-12-19 11:00:00+00:00,174,768,942,71,-6.51
2017-12-19 12:00:00+00:00,157,654,811,70,-6.039
2017-12-19 13:00:00+00:00,110,677,787,70,-6.045
2017-12-19 14:00:00+00:00,50,586,636,72,-6.894
2017-12-19 15:00:00+00:00,15,572,587,77,-8.899
2017-12-19 16:00:00+00:00,8,705,713,85,-10.216
2017-12-19 17:00:00+00:00,8,743,751,83,-10.473
2017-12-19 18:00:00+00:00,0,770,770,72,-10.424
2017-12-19 19:00:00+00:00,0,661,661,68,-10.466
2017-12-19 20:00:00+00:00,0,611,611,60,-10.435
2017-12-19 21:00:00+00:00,0,551,551,49,-10.241
2017-12-19 22:00:00+00:00,0,484,484,41,-9.98
2017-12-19 23:00:00+00:00,0,372,372,41,-9.853
2017-12-20 00:00:00+00:00,0,325,325,38,-9.699
2017-12-20 01:00:00+00:00,0,300,300,37,-10.001
2017-12-20 02:00:00+00:00,0,279,279,37,-10.373
2017-12-20 03:00:00+00:00,0,272,272,38,-10.621
2017-12-20 04:00:00+00:00,0,236,236,41,-10.629
2017-12-20 05:00:00+00:00,0,190,190,55,-10.727
2017-12-20 06:00:00+00:00,8,181,189,76,-10.664
2017-12-20 07:00:00+00:00,18,156,174,80,-10.303
2017-12-20 08:00:00+00:00,54,166,220,78,-9.221
2017-12-20 09:00:00+00:00,101,229,330,77,-6.51
2017-12-20 10:00:00+00:00,138,309,447,77,-4.841
2017-12-20 11:00:00+00:00,152,344,496,73,-4.145
2017-12-20 12:00:00+00:00,139,388,527,71,-3.976
2017-12-20 13:00:00+00:00,100,425,525,70,-4.078
2017-12-20 14:00:00+00:00,47,351,398,73,-5.077
2017-12-20 15:00:00+00:00,15,325,340,73,-6.933
2017-12-20 16:00:00+00:00,8,372,380,79,-8.138
2017-12-20 17:00:00+00:00,8,482,490,76,-8.866
2017-12-20 18:00:00+00:00,0,626,626,68,-9.444
2017-12-20 19:00:00+00:00,0,727,727,59,-9.971
2017-12-20 20:00:00+00:00,0,781,781,50,-10.446
2017-12-20 21:00:00+00:00,0,712,712,44,-10.942
2017-12-20 22:00:00+00:00,0,608,608,37,-11.153
2017-12-20 23:00:00+00:00,0,579,579,35,-11.304
2017-12-21 00:00:00+00:00,0,503,503,33,-11.496
2017-12-21 01:00:00+00:00,0,549,549,32,-11.992
2017-12-21 02:00:00+00:00,0,568,568,33,-12.313
2017-12-21 03:00:00+00:00,0,613,613,33,-12.1
2017-12-21 04:00:00+00:00,0,606,606,33,-11.844
2017-12-21 05:00:00+00:00,0,500,500,40,-11.267
2017-12-21 06:00:00+00:00,8,521,529,55,-10.56
2017-12-21 07:00:00+00:00,17,549,566,56,-9.5
2017-12-21 08:00:00+00:00,48,578,626,55,-7.097
2017-12-21 09:00:00+00:00,84,681,765,54,-4.879
2017-12-21 10:00:00+00:00,109,673,782,55,-3.229
2017-12-21 11:00:00+00:00,116,712,828,54,-1.846
2017-12-21 12:00:00+00:00,104,712,816,53,-1.087
2017-12-21 13:00:00+00:00,75,888,963,49,-0.905
2017-12-21 14:00:00+00:00,36,935,971,50,-1.094
2017-12-21 15:00:00+00:00,13,973,986,53,-1.495
2017-12-21 16:00:00+00:00,8,1085,1093,60,-1.723
2017-12-21 17:00:00+00:00,8,1211,1219,55,-1.692
2017-12-21 18:00:00+00:00,0,1445,1445,50,-1.522
2017-12-21 19:00:00+00:00,0,1426,1426,45,-1.422
2017-12-21 20:00:00+00:00,0,1455,1455,40,-1.708
2017-12-21 21:00:00+00:00,0,1510,1510,39,-2.021
2017-12-21 22:00:00+00:00,0,1620,1620,33,-2.257
2017-12-21 23:00:00+00:00,0,1604,1604,33,-2.354
2017-12-22 00:00:00+00:00,0,1610,1610,32,-2.495
2017-12-22 01:00:00+00:00,0,1597,1597,31,-2.608
2017-12-22 02:00:00+00:00,0,1513,1513,30,-2.632
2017-12-22 03:00:00+00:00,0,1331,1331,31,-2.694
2017-12-22 04:00:00+00:00,0,1207,1207,33,-2.805
2017-12-22 05:00:00+00:00,0,1193,1193,40,-2.894
2017-12-22 06:00:00+00:00,8,1068,1076,48,-2.952
2017-12-22 07:00:00+00:00,22,739,761,52,-2.836
2017-12-22 08:00:00+00:00,63,551,614,51,-2.22
2017-12-22 09:00:00+00:00,115,621,736,50,-1.369
2017-12-22 10:00:00+00:00,155,581,736,49,-0.847
2017-12-22 11:00:00+00:00,168,585,753,48,-0.492
2017-12-22 12:00:00+00:00,150,730,880,43,-0.221
2017-12-22 13:00:00+00:00,107,756,863,41,-0.11
2017-12-22 14:00:00+00:00,51,682,733,41,-0.277
2017-12-22 15:00:00+00:00,16,864,880,46,-0.989
2017-12-22 16:00:00+00:00,8,1053,1061,47,-1.662
2017-12-22 17:00:00+00:00,8,1177,1185,44,-2.189
2017-12-22 18:00:00+00:00,0,1343,1343,39,-2.597
2017-12-22 19:00:00+00:00,0,1563,1563,39,-2.765
2017-12-22 20:00:00+00:00,0,1843,1843,37,-2.669
2017-12-22 21:00:00+00:00,0,2077,2077,35,-2.409
2017-12-22 22:00:00+00:00,0,2133,2133,32,-2.269
2017-12-22 23:00:00+00:00,0,2133,2133,29,-2.296
2017-12-23 00:00:00+00:00,0,2054,2054,26,-2.409
2017-12-23 01:00:00+00:00,0,1872,1872,20,-2.441
2017-12-23 02:00:00+00:00,0,1778,1778,20,-2.456
2017-12-23 03:00:00+00:00,0,1726,1726,16,-2.502
2017-12-23 04:00:00+00:00,0,1429,1429,15,-2.553
2017-12-23 05:00:00+00:00,0,1247,1247,11,-2.566
2017-12-23 06:00:00+00:00,8,1233,1241,15,-2.593
2017-12-23 07:00:00+00:00,22,1473,1495,18,-2.494
2017-12-23 08:00:00+00:00,67,1391,1458,23,-1.78
2017-12-23 09:00:00+00:00,125,1318,1443,22,-1.077
2017-12-23 10:00:00+00:00,166,1637,1803,22,-0.803
2017-12-23 11:00:00+00:00,179,1822,2001,17,-0.7
2017-12-23 12:00:00+00:00,161,1949,2110,12,-0.709
2017-12-23 13:00:00+00:00,115,2036,2151,11,-0.855
2017-12-23 14:00:00+00:00,54,2258,2312,10,-1.26
2017-12-23 15:00:00+00:00,17,2294,2311,12,-2.182
2017-12-23 16:00:00+00:00,8,2088,2096,17,-3
2017-12-23 17:00:00+00:00,8,2080,2088,15,-3.461
2017-12-23 18:00:00+00:00,0,2134,2134,13,-4.232
2017-12-23 19:00:00+00:00,0,2239,2239,9,-5.073
2017-12-23 20:00:00+00:00,0,2198,2198,2,-5.238
2017-12-23 21:00:00+00:00,0,2333,2333,-1,-5.437
2017-12-23 22:00:00+00:00,0,2371,2371,-22,-5.665
2017-12-23 23:00:00+00:00,0,2276,2276,-16,-5.978
2017-12-24 00:00:00+00:00,0,2119,2119,-41,-5.971
2017-12-24 01:00:00+00:00,0,2335,2335,-44,-6.009
2017-12-24 02:00:00+00:00,0,2516,2516,-41,-6.206
2017-12-24 03:00:00+00:00,0,2278,2278,-32,-6.215
2017-12-24 04:00:00+00:00,0,2049,2049,-35,-6.169
2017-12-24 05:00:00+00:00,0,2102,2102,-38,-6.177
2017-12-24 06:00:00+00:00,8,2115,2123,-15,-6.049
2017-12-24 07:00:00+00:00,27,2178,2205,-2,-5.64
2017-12-24 08:00:00+00:00,81,2089,2170,4,-3.855
2017-12-24 09:00:00+00:00,152,1904,2056,3,-1.232
2017-12-24 10:00:00+00:00,208,1714,1922,8,0.565
2017-12-24 11:00:00+00:00,225,1594,1819,8,0.885
2017-12-24 12:00:00+00:00,195,1545,1740,0,1.057
2017-12-24 13:00:00+00:00,135,1484,1619,-2,1.194
2017-12-24 14:00:00+00:00,63,1633,1696,-1,1.404
2017-12-24 15:00:00+00:00,19,1645,1664,7,0.862
2017-12-24 16:00:00+00:00,8,1717,1725,13,-0.181
2017-12-24 17:00:00+00:00,8,1696,1704,17,-0.849
2017-12-24 18:00:00+00:00,0,1457,1457,16,-1.337
2017-12-24 19:00:00+00:00,0,1255,1255,13,-1.748
2017-12-24 20:00:00+00:00,0,1106,1106,11,-2.055
2017-12-24 21:00:00+00:00,0,1217,1217,13,-2.371
2017-12-24 22:00:00+00:00,0,1219,1219,6,-2.489
2017-12-24 23:00:00+00:00,0,1223,1223,-9,-2.527
2017-12-25 00:00:00+00:00,0,1131,1131,-12,-2.439
2017-12-25 01:00:00+00:00,0,1143,1143,-18,-2.31
2017-12-25 02:00:00+00:00,0,1277,1277,-16,-2.242
2017-12-25 03:00:00+00:00,0,1230,1230,-20,-2.195
2017-12-25 04:00:00+00:00,0,915,915,-15,-2.01
2017-12-25 05:00:00+00:00,0,674,674,-3,-1.731
2017-12-25 06:00:00+00:00,8,485,493,3,-1.461
2017-12-25 07:00:00+00:00,27,296,323,4,-1.127
2017-12-25 08:00:00+00:00,87,173,260,9,-0.021
2017-12-25 09:00:00+00:00,164,105,269,9,1.698
2017-12-25 10:00:00+00:00,223,66,289,12,2.608
2017-12-25 11:00:00+00:00,243,62,305,10,2.66
2017-12-25 12:00:00+00:00,216,94,310,8,2.505
2017-12-25 13:00:00+00:00,150,175,325,8,2.236
2017-12-25 14:00:00+00:00,69,253,322,12,1.87
2017-12-25 15:00:00+00:00,19,396,415,21,0.724
2017-12-25 16:00:00+00:00,8,517,525,26,-0.804
2017-12-25 17:00:00+00:00,8,584,592,26,-1.928
2017-12-25 18:00:00+00:00,0,665,665,28,-2.857
2017-12-25 19:00:00+00:00,0,718,718,25,-3.638
2017-12-25 20:00:00+00:00,0,707,707,21,-4.419
2017-12-25 21:00:00+00:00,0,655,655,23,-4.966
2017-12-25 22:00:00+00:00,0,598,598,15,-5.36
2017-12-25 23:00:00+00:00,0,627,627,9,-5.841
2017-12-26 00:00:00+00:00,0,527,527,1,-6.261
2017-12-26 01:00:00+00:00,0,427,427,0,-6.57
2017-12-26 02:00:00+00:00,0,336,336,0,-6.744
2017-12-26 03:00:00+00:00,0,286,286,-5,-7.019
2017-12-26 04:00:00+00:00,0,242,242,0,-7.364
2017-12-26 05:00:00+00:00,0,178,178,-3,-7.831
2017-12-26 06:00:00+00:00,8,150,158,0,-8.538
2017-12-26 07:00:00+00:00,20,118,138,4,-9.115
2017-12-26 08:00:00+00:00,65,97,162,5,-8.055
2017-12-26 09:00:00+00:00,124,96,220,6,-3.887
2017-12-26 10:00:00+00:00,175,86,261,10,-1.947
2017-12-26 11:00:00+00:00,202,84,286,8,-1.261
2017-12-26 12:00:00+00:00,187,80,267,3,-0.945
2017-12-26 13:00:00+00:00,133,93,226,2,-0.845
2017-12-26 14:00:00+00:00,63,111,174,4,-1.274
2017-12-26 15:00:00+00:00,19,117,136,9,-2.274
2017-12-26 16:00:00+00:00,8,118,126,19,-2.952
2017-12-26 17:00:00+00:00,8,102,110,18,-3.74
2017-12-26 18:00:00+00:00,0,93,93,18,-5.202
2017-12-26 19:00:00+00:00,0,97,97,25,-6.625
2017-12-26 20:00:00+00:00,0,103,103,21,-7.678
2017-12-26 21:00:00+00:00,0,91,91,22,-8.388
2017-12-26 22:00:00+00:00,0,67,67,15,-8.462
2017-12-26 23:00:00+00:00,0,96,96,11,-7.964
2017-12-27 00:00:00+00:00,0,139,139,5,-6.877
2017-12-27 01:00:00+00:00,0,171,171,0,-5.544
2017-12-27 02:00:00+00:00,0,217,217,-2,-4.407
2017-12-27 03:00:00+00:00,0,290,290,6,-3.153
2017-12-27 04:00:00+00:00,0,401,401,11,-2.389
2017-12-27 05:00:00+00:00,0,515,515,20,-1.794
2017-12-27 06:00:00+00:00,8,817,825,36,-1.461
2017-12-27 07:00:00+00:00,23,1230,1253,32,-1.151
2017-12-27 08:00:00+00:00,72,1267,1339,34,-0.79
2017-12-27 09:00:00+00:00,136,1426,1562,33,-0.495
2017-12-27 10:00:00+00:00,182,1935,2117,32,-0.31
2017-12-27 11:00:00+00:00,197,2309,2506,31,-0.307
2017-12-27 12:00:00+00:00,175,2446,2621,31,-0.391
2017-12-27 13:00:00+00:00,121,2452,2573,31,-0.413
2017-12-27 14:00:00+00:00,56,2418,2474,33,-0.622
2017-12-27 15:00:00+00:00,17,2295,2312,37,-0.981
2017-12-27 16:00:00+00:00,8,2285,2293,40,-1.195
2017-12-27 17:00:00+00:00,8,2174,2182,38,-1.383
2017-12-27 18:00:00+00:00,0,2248,2248,38,-1.903
2017-12-27 19:00:00+00:00,0,2199,2199,37,-2.052
2017-12-27 20:00:00+00:00,0,2200,2200,32,-1.786
2017-12-27 21:00:00+00:00,0,2231,2231,32,-1.571
2017-12-27 22:00:00+00:00,0,2126,2126,26,-1.571
2017-12-27 23:00:00+00:00,0,1851,1851,33,-2.426
2017-12-28 00:00:00+00:00,0,1552,1552,30,-3.446
2017-12-28 01:00:00+00:00,0,1463,1463,28,-3.813
2017-12-28 02:00:00+00:00,0,1527,1527,27,-4.626
2017-12-28 03:00:00+00:00,0,1238,1238,26,-5.602
2017-12-28 04:00:00+00:00,0,1354,1354,28,-6.788
2017-12-28 05:00:00+00:00,0,1599,1599,35,-7.804
2017-12-28 06:00:00+00:00,8,1532,1540,41,-8.734
2017-12-28 07:00:00+00:00,17,1223,1240,43,-8.815
2017-12-28 08:00:00+00:00,50,1214,1264,43,-6.919
2017-12-28 09:00:00+00:00,94,1019,1113,43,-5.006
2017-12-28 10:00:00+00:00,125,1139,1264,42,-4.555
2017-12-28 11:00:00+00:00,143,1357,1500,41,-4.421
2017-12-28 12:00:00+00:00,137,1455,1592,39,-4.436
2017-12-28 13:00:00+00:00,100,1319,1419,36,-4.615
2017-12-28 14:00:00+00:00,49,1231,1280,36,-4.861
2017-12-28 15:00:00+00:00,16,1248,1264,41,-5.149
2017-12-28 16:00:00+00:00,8,1335,1343,41,-5.608
2017-12-28 17:00:00+00:00,8,1636,1644,40,-6.043
2017-12-28 18:00:00+00:00,0,1930,1930,35,-6.351
2017-12-28 19:00:00+00:00,0,2250,2250,31,-6.508
2017-12-28 20:00:00+00:00,0,2352,2352,26,-6.562
2017-12-28 21:00:00+00:00,0,2388,2388,26,-6.616
2017-12-28 22:00:00+00:00,0,2367,2367,16,-6.783
2017-12-28 23:00:00+00:00,0,2261,2261,7,-7.123
2017-12-29 00:00:00+00:00,0,2209,2209,5,-7.628
2017-12-29 01:00:00+00:00,0,2233,2233,4,-8.162
2017-12-29 02:00:00+00:00,0,1950,1950,3,-8.659
2017-12-29 03:00:00+00:00,0,1943,1943,4,-9.093
2017-12-29 04:00:00+00:00,0,1960,1960,9,-9.598
2017-12-29 05:00:00+00:00,0,2073,2073,15,-9.952
2017-12-29 06:00:00+00:00,8,2249,2257,26,-10.188
2017-12-29 07:00:00+00:00,19,2156,2175,31,-10.47
2017-12-29 08:00:00+00:00,58,2077,2135,32,-9.577
2017-12-29 09:00:00+00:00,111,1987,2098,31,-7.853
2017-12-29 10:00:00+00:00,153,2173,2326,30,-7.243
2017-12-29 11:00:00+00:00,172,2312,2484,29,-7.011
2017-12-29 12:00:00+00:00,158,2078,2236,28,-6.935
2017-12-29 13:00:00+00:00,115,1516,1631,31,-7.095
2017-12-29 14:00:00+00:00,56,970,1026,35,-8.079
2017-12-29 15:00:00+00:00,18,855,873,39,-10.483
2017-12-29 16:00:00+00:00,8,832,840,41,-13.359
2017-12-29 17:00:00+00:00,8,604,612,38,-15.472
2017-12-29 18:00:00+00:00,0,276,276,34,-16.348
2017-12-29 19:00:00+00:00,0,208,208,31,-14.926
2017-12-29 20:00:00+00:00,0,225,225,29,-13.35
2017-12-29 21:00:00+00:00,0,304,304,29,-12.558
2017-12-29 22:00:00+00:00,0,633,633,20,-11.708
2017-12-29 23:00:00+00:00,0,1161,1161,16,-11.329
2017-12-30 00:00:00+00:00,0,1496,1496,11,-11.126
2017-12-30 01:00:00+00:00,0,1279,1279,8,-10.732
2017-12-30 02:00:00+00:00,0,839,839,8,-10.096
2017-12-30 03:00:00+00:00,0,474,474,9,-9.575
2017-12-30 04:00:00+00:00,0,399,399,10,-9.442
2017-12-30 05:00:00+00:00,0,403,403,9,-9.557
2017-12-30 06:00:00+00:00,8,349,357,11,-9.123
2017-12-30 07:00:00+00:00,18,239,257,17,-8.24
2017-12-30 08:00:00+00:00,56,184,240,23,-7.642
2017-12-30 09:00:00+00:00,105,141,246,26,-6.577
2017-12-30 10:00:00+00:00,145,114,259,27,-5.175
2017-12-30 11:00:00+00:00,157,144,301,25,-4.406
2017-12-30 12:00:00+00:00,139,351,490,22,-3.863
2017-12-30 13:00:00+00:00,98,584,682,16,-3.697
2017-12-30 14:00:00+00:00,48,955,1003,15,-3.524
2017-12-30 15:00:00+00:00,16,1344,1360,16,-3.393
2017-12-30 16:00:00+00:00,8,1555,1563,19,-2.878
2017-12-30 17:00:00+00:00,8,1277,1285,17,-2.04
2017-12-30 18:00:00+00:00,0,920,920,14,-1.676
2017-12-30 19:00:00+00:00,0,993,993,7,-1.588
2017-12-30 20:00:00+00:00,0,753,753,2,-1.172
2017-12-30 21:00:00+00:00,0,634,634,1,-1.123
2017-12-30 22:00:00+00:00,0,622,622,-7,-0.66
2017-12-30 23:00:00+00:00,0,703,703,-20,-0.204
2017-12-31 00:00:00+00:00,0,646,646,-28,-0.058
2017-12-31 01:00:00+00:00,0,699,699,-39,0.055
2017-12-31 02:00:00+00:00,0,620,620,-26,0.085
2017-12-31 03:00:00+00:00,0,619,619,-18,0.073
2017-12-31 04:00:00+00:00,0,627,627,-20,0.102
2017-12-31 05:00:00+00:00,0,586,586,-28,0.047
2017-12-31 06:00:00+00:00,8,500,508,-17,-0.801
2017-12-31 07:00:00+00:00,25,495,520,-5,-1.491
2017-12-31 08:00:00+00:00,82,652,734,1,-0.813
2017-12-31 09:00:00+00:00,162,923,1085,-15,0.702
2017-12-31 10:00:00+00:00,227,1099,1326,-14,1.618
2017-12-31 11:00:00+00:00,252,1150,1402,-25,2.063
2017-12-31 12:00:00+00:00,228,1014,1242,-33,2.235
2017-12-31 13:00:00+00:00,163,908,1071,-37,2.073
2017-12-31 14:00:00+00:00,79,785,864,-21,1.616
2017-12-31 15:00:00+00:00,23,658,681,3,0.191
2017-12-31 16:00:00+00:00,8,525,533,14,-1.8
2017-12-31 17:00:00+00:00,8,408,416,13,-3.152
2017-12-31 18:00:00+00:00,0,422,422,7,-4.192
2017-12-31 19:00:00+00:00,0,583,583,0,-5.023
2017-12-31 20:00:00+00:00,0,629,629,2,-5.447
2017-12-31 21:00:00+00:00,0,710,710,10,-5.479
2017-12-31 22:00:00+00:00,0,839,839,6,-5.338
2017-12-31 23:00:00+00:00,0,915,915,-17,-5.462
